border_size=1
usage=map

Gll         , Gll         , Gll         , Gll         , Rb          , Gs          , Gs          , Gs          , Gs          , Gs          , Gll         , Gs          , Gs          , Gs          , Gs          , Gs          , Gs          , Gs          , Gs          , Gs          , Gs          , Gs          , Gs          , Gs          , Gs          , Gs          , Hh          , Hhd         , Hhd         , Hhd         , Ha          , Ha          , Ha          , Ha          , Ha^Fma      , Ha^Fma      , Ha^Fma      , Ha^Fma      , Ha^Fma      , Ha^Fma      , Ms          , Ms          , Ms          , Md^Xm       , Mm^Xm       , Ms^Xm       , Ms^Xm       
Gll         , Gs          , Gd^Vo       , Gll         , Gll         , Rb          , Gs          , Gs          , Gs          , Gs          , Gs          , Gs          , Gll         , Gd^Vo       , Gs          , Gd          , Gd          , Gd          , Gs          , Gs          , Gs          , Gd^Vo       , Gs          , Gs          , Gs          , Hh          , Hh          , Hhd         , Hhd         , Ha          , Ha          , Ha          , Ha^Fma      , Ha^Fma      , Ha^Fma      , Ha^Fma      , Ha^Fma      , Ha^Fma      , Ha^Fma      , Ha^Fma      , Ms          , Ms          , Ms          , Md^Xm       , Mm^Xm       , Ms^Xm       , Ms^Xm       
Gs          , Gs          , Gs          , Gs          , Gs          , Rb          , Rb          , Gs          , Gs          , Gs          , Co          , Gs          , Gs          , Gs          , Gs          , Gd          , Gd          , Gs          , Gd^Vo       , Gs          , Gs          , Gs          , Gs          , Hh          , Hh          , Hh          , Hhd         , Hhd         , Aa^Voa      , Ha          , Ha^Fma      , Ha^Fma      , Ha^Fma      , Ha^Fma      , Ha^Fpa      , Ha^Fma      , Ha^Fpa      , Ha^Fma      , Ha^Fma      , Ha^Fma      , Ms          , Ms          , Ms          , Md^Xm       , Md^Xm       , Mm^Xm       , Mm^Xm       
Gs          , Gs          , Gs          , Gs          , Gs          , Gs          , Rb          , Gs          , Gs          , Co          , 3 Ko        , Co          , Gs          , Gs          , Gd          , Gd          , Gs          , Gs          , Gs          , Gs          , Gs          , Gs          , Hh          , Hh          , Hhd         , Hhd         , Ha          , Ha          , Ha          , Ha^Fma      , Ha^Fma      , Ha^Fma      , Ha^Fma      , Ha^Fpa      , Ha^Fpa      , Ha^Fma      , Ha^Fma      , Ha^Fma      , Ha^Fma      , Ha^Fma      , Ha^Fma      , Ms          , Ms          , Ms          , Ms          , Md^Xm       , Ms          
Gs          , Gs          , Gd          , Gd          , Gd          , Gs          , Gs          , Rb          , Rb          , Co          , Co          , Co          , Gs          , Gs          , Gs          , Gs          , Gs          , Gd          , Gs          , Gs          , Hh          , Hh          , Hhd         , Hhd         , Ha          , Coa         , Ha          , Ha          , Ha^Fma      , Ha^Fma      , Ha^Fma      , Ms^Xm       , Ms^Xm       , Ha^Fma      , Ha^Fma      , Ha^Fma      , Ha^Fma      , Ha^Fma      , Ha^Fma      , Ha^Fma      , Ms          , Ms          , Ms          , Ms          , Ms          , Ms          , Ms          
Gs          , Gs          , Gs          , Gd          , Gs          , Gs          , Gd^Vo       , Gs          , Gll         , Rb          , Rb          , Gd          , Gs          , Gd          , Gs          , Gs          , Gs          , Gd          , Gs          , Gs          , Hh          , Hh          , Hhd         , Hhd         , Aa^Voa      , Ha          , Ha^Fma      , Ha^Fma      , Ms^Xm       , Ms^Xm       , Ha          , Ha          , Ha          , Ms^Xm       , Ms^Xm       , Ms^Xm       , Ms^Xm       , Ha^Fma      , Ha^Fma      , Ha^Fma      , Ms          , Ms          , Ms          , Ms          , Ha^Fma      , Ms          , Ms          
Gll^Fmf     , Gs          , Gs          , Gs          , Gs          , Gs          , Gs          , Gs          , Gs          , Rb          , Rb          , Gd          , Gd          , Gs          , Gs          , Gd          , Gs          , Gs          , Gs          , Gs          , Hh          , Hh          , Hhd         , Hhd         , Ha          , Ha          , Ha^Fma      , Ms^Xm       , Ha          , Ha          , Ha^Fma      , Ha^Fma      , Ha^Fma      , Ha          , Ha          , Ha          , Ha          , Ha^Vhha     , Ha^Fma      , Ms          , Ha^Fma      , Ms          , Ha^Fma      , Ha^Fma      , Ha^Fma      , Ha^Fma      , Ms          
Gll^Fmf     , Gll^Fmf     , Gll^Fmf     , Gs          , Gs          , Gs          , Gs          , Gs          , Gll         , Gs          , Rb          , Gd          , Gd          , Gs          , Gd^Vo       , Gs          , Gd          , Gs          , Gs          , Gs          , Hh          , Hhd         , Hhd         , Hhd         , Ms^Xm       , Ha^Fma      , Ha          , Ha          , Ms^Xm       , Ms^Xm       , Ms          , Ha^Fma      , Ms          , Ha^Fma      , Ha^Fma      , Ha^Fma      , Ha^Fma      , Ha          , Ms^Xm       , Ha^Fma      , Ha^Fma      , Ha^Fma      , Ha^Fma      , Ha^Vhha     , Ha^Fma      , Ha^Fma      , Ha^Fma      
Gll^Fmf     , Gll^Fmf     , Gll^Fmf     , Gll^Fmf     , Gs          , Gs          , Gll         , Gll         , Gll         , Gs          , Gs          , Rb          , Rb          , Gs          , Gll         , Gs          , Gs          , Gs          , Gs          , Hh          , Hh          , Hhd         , Hhd         , Ha          , Ms^Xm       , Ha^Fma      , Ha          , Ha^Fma      , Ms^Xm       , Ms          , Ms          , Ms          , Ms          , Ms          , Ha^Fma      , Ha^Fma      , Ha^Fma      , Ha          , Ms^Xm       , Ha^Fma      , Ha^Vhha     , Ha^Fma      , Ha^Fma      , Ha^Fma      , Ha^Fpa      , Ha^Fpa      , Ha^Fma      
Gll^Fmf     , Gll^Fmf     , Gll^Fmf     , Gll^Fmf     , Gll^Fmf     , Gs          , Gs          , Gll         , Gll         , Gs          , Gd^Vo       , Gll         , Rb          , Rb          , Co          , Gs          , Gs          , Gs          , Gs          , Gs          , Hh          , Hhd         , Hhd         , Ha          , Ms^Xm       , Ha^Fma      , Ha          , Ms^Xm       , Ms          , Ms          , 4 Ms        , Ms          , Ms          , Ha^Fma      , Ha^Fma      , Ha^Fma      , Ha^Fma      , Ha          , Ha^Fma      , Ha^Fma      , Ha^Fma      , Ha^Fpa      , Ha          , Ha^Fma      , Ha^Fma      , Ha^Fma      , Ha^Fma      
Gll^Fmf     , Gll^Fmf     , Gll^Fmf     , Gll^Fmf     , Gll^Fmf     , Gs          , Gs          , Gs          , Gs          , Gs          , Gs          , Gll         , Gll         , Rb          , Rb          , Gs          , Gs          , Gs          , Gs          , Gs          , Hh          , Hhd         , Hhd         , Hhd         , Ha          , Ha^Fma      , Ha          , Ms^Xm       , Ms          , Ms^Xm       , Ms          , Ms          , Ha^Fma      , Ha^Fma      , Ha^Fma      , Ha^Fma      , Ha          , Ha          , Ha          , Ha^Fma      , Ha          , Ha          , Ha^Fma      , Ha          , Ha          , Cha         , Ha          
Gll^Fmf     , Gll^Fmf     , Gll^Fmf     , Gll^Fmf     , Gll^Fmf     , Gs          , Gs          , Gs          , Gs          , Gs          , Gs          , Gs          , Gs          , Gll         , Rb          , Gs          , Gs          , Gs^Vc       , Gs          , Gs          , Hh          , Hh          , Hhd         , Hhd         , Ha          , Ha^Fma      , Ha          , Ms^Xm       , Ms^Xm       , Ms          , Ha^Fma      , Ha          , Ha          , Ha^Fma      , Ha          , Ha          , Ms          , Ha^Fpa      , Ha^Fma      , Ha          , Ha^Fma      , Ha^Fma      , Ai          , Ha^Fma      , Ha^Fma      , Ha          , Ha^Fma      
Gll^Fmf     , Gll^Fmf     , Gll^Fmf     , Gll^Fmf     , Gll^Fmf     , Gll^Fmf     , Gll^Fmf     , Gs          , Gs          , Gs          , Gs          , Gs          , Gs          , Gs          , Rb          , Gs          , Gs          , Gs          , Gs          , Gs          , Gs          , Hh          , Hh          , Hhd         , Ha          , Md^Xm       , Ha          , Ha          , Ha^Fma      , Ms^Xm       , Ms^Xm       , Ha^Fma      , Ms          , Ha          , Ms          , Ms          , Ha^Fma      , Ha^Fma      , Ha^Fma      , Ha^Fma      , Ai          , Ai          , Ha          , Ai          , Ha          , Cha         , Ha^Fma      
Gd^Fdf      , Gll^Fmf     , Gd^Fdf      , Gll^Fmf     , Gll^Fmf     , Gll^Fmf     , Gll^Fmf     , Gll^Fmf     , Gs          , Gs          , Gs          , Gs          , Gs          , Gs          , Gs          , Rb          , Rb          , Gs          , Gs          , Gs          , Gs          , Gs          , Hh          , Hhd         , Hhd         , Ha          , Ha^Fma      , Ha          , Md^Xm       , Ha^Fma      , Ha^Fma      , Ms^Xm       , Ha^Fpa      , Ms^Xm       , Ha^Fma      , Ha^Fpa      , Ha^Fma      , Ha^Fma      , Ha^Fma      , Ai          , Ha          , Ha          , Ha          , Ai          , Ai          , Ha^Fma      , Ha^Fma      
Gd^Fdf      , Gll^Fmf     , Gd^Fmw      , Gll^Fmf     , Gll^Fmf     , Gll^Fmf     , Gd^Fdf      , Gll^Fmf     , Gll^Fmf     , Gs          , Gs          , Gs          , Gs          , Gs          , Gs          , Gs          , Gs          , Rb          , Rb          , Gs          , Gs          , Gs          , Gs          , Hh          , Hh          , Ha          , Rd          , Ha          , Ha^Fma      , Ha^Fma      , Ha^Fma      , Ha^Fma      , Ha^Vhha     , Ha^Fma      , Ha^Fma      , Ha^Fma      , Ha^Fma      , Ha^Fma      , Ai          , Ai          , Ha          , Ha          , Ha          , Ha          , Ha          , Ai          , Ai          
Gll^Fmf     , Gll^Fmf     , Gd^Fmw      , Gll^Fmf     , Gd^Fmw      , Gll^Fmf     , Gll^Fmf     , Gll^Fmf     , Gll^Fmf     , Gs          , Gs          , Gs          , Gs          , Re^Vct      , Gs          , Gs          , Gs          , Gs          , Rb          , Rb          , Gs          , Gs          , Gs          , Hh          , Hh          , Cea         , Rd          , Ha          , Ha          , Ha          , Ha          , Ha          , Ha          , Ha^Fma      , Ha          , Ha          , Ai          , Ai          , Ha          , Ha          , Ms          , Ha^Vhha     , Ms          , Ms          , Ms          , Ha          , Ha          
Gll^Fmf     , Gll^Fmf     , Gll^Fmf     , Gd^Fdf      , Gll^Fmf     , Gll^Fmf     , Gll^Fmf     , Gll^Fp      , Gll^Fmf     , Gs          , Gs          , Gs          , Gs          , Gs          , Gs          , Gs          , Gs          , Gs          , Gs          , Rb          , Rb          , Gs          , Gs          , Gs          , Gs          , Ha          , Rd          , Cea         , Hhd         , Hhd         , Ha          , Ha          , Ai          , Ai          , Ai          , Ai          , Ha          , Ha          , Ms          , Ms          , Ms          , Ms          , Ms          , Ms          , Ms          , Ms          , Ms          
Gll^Fmf     , Gll^Fmf     , Gg^Ve       , Gll^Fmf     , Gll^Fmf     , Gll^Fmf     , Gll^Fmf     , Gll^Fmf     , Gll^Fmf     , Gs          , Gs          , Gs          , Gs          , Gs          , Gs          , Gs          , Gs          , Gs          , Gs          , Gs          , Rb          , Gs          , Gs          , Gs          , Gs          , Rd          , Gs          , Rd          , Rd          , Hhd         , Rd          , Ha          , Ai          , Ha          , Ha          , Ha          , Ha^Vhha     , Ms          , Ms          , Ms          , Ms          , Ms          , Ms          , Ms          , Ms          , Ms          , Ms          
Gll^Fmf     , Gll^Fmf     , Gll^Fp      , Gd^Fmw      , Gll^Fmf     , Gll^Fmf     , Gd^Fmw      , Gll^Fmf     , Gll^Fmf     , Gll^Fmf     , Gs          , Gs          , Gs          , Gs          , Gs          , Gs          , Gs          , Gs          , Gs          , Gs          , Gs          , Rb          , Rb          , Ce          , Rd          , Rd          , Gs          , Hh          , Hhd         , Rd          , Wwf^Bw\     , Ai          , Rd          , Ha          , Ms          , Ms          , Ms          , Ms          , Ms          , Ms          , Ms          , Ms          , Ms          , Ms          , Ms          , Ms          , Ms          
Gll^Fmf     , Gll^Fmf     , Gll^Fmf     , Gll^Fmf     , Gll^Fmf     , Gll^Fmf     , Gll^Fmf     , Gd^Fdf      , Gll^Fmf     , Gll^Fmf     , Gs          , Gs          , Gs          , Gs          , Gs          , Gs          , Gs          , Gs          , Re^Vct      , Gs          , Gs          , Gs          , Gs          , Rd          , Rd          , Gs          , Gs          , Hh          , Wwr         , Wwf         , Rd          , Rd          , Rd          , Ha          , Ms          , Ms          , Ms          , Ms          , Ms          , Ms          , Ms          , Ms          , Ms          , Ms          , Ms          , Ms          , Ms          
Gll^Fmf     , Gll^Fmf     , Gg^Ve       , Gll^Fmf     , Gll^Fmf     , Gll^Fmf     , Gll^Fmf     , Gll^Fmf     , Gd^Fdf      , Gll^Fmf     , Gs          , Gs          , Gs          , Gs          , Gs          , Gs          , Gs          , Gs          , Gs          , Gs          , Gs          , Gs          , Rp          , Rp          , Gs          , Gs          , Wwr         , Wwr         , Hh^Vhh      , Rd          , Rd          , Rd          , Ha          , Ha          , Ha^Vhha     , Ms          , Ms          , Ms          , Ms          , Ms          , Ms          , Ms          , Ms          , Ms^Xm       , Ms^Xm       , Ms^Xm       , Ms^Xm       
Gll^Fp      , Gll^Fmf     , Gll^Fp      , Gll^Fp      , Gll^Fmf     , Gll^Fmf     , Gg^Ve       , Gll^Fmf     , Gll^Fmf     , Gll^Fmf     , Gll^Fmf     , Gs          , Gs          , Gs          , Gs          , Gs          , Gs          , Gs          , Gs          , Gs          , Rp          , Rp          , Gs          , Gs          , Gs          , Gs          , Wwr         , Hh          , Hhd         , Rb          , Rb          , Ha          , Ha          , Ms          , Ms          , Ms          , Ms          , Ms          , Ms          , Ms          , Ms          , Ms          , Ms^Xm       , Ms^Xm       , Ms^Xm       , Ms^Xm       , Ms^Xm       
Gll^Fmf     , Gll^Fmf     , Gll^Fmf     , Gd^Fmw      , Gll^Fmf     , Gll^Fmf     , Gll^Fmf     , Gll^Fmf     , Gll^Fmf     , Gll^Fmf     , Gll^Fmf     , Gs          , Gs          , Gs          , Gs          , Gs          , Rp          , Gs          , Rp          , Rp          , Gs          , Gs          , Gs          , Gs          , Gs          , Gs          , Ww          , Hh          , Hh          , Hhd         , Rd          , Rd          , Ha          , Ms          , Ms          , Ms          , Ms          , Ms          , Ms          , Ms          , Ms          , Ms          , Ms^Xm       , Ms^Xm       , Ms^Xm       , Ms^Xm       , Ms^Xm       
Gs^Fds      , Gll^Fmf     , Gll^Fmf     , Gll^Fmf     , Rd          , Gll^Fmf     , Rd          , Gll^Fmf     , Rd          , Gll^Fmf     , Gs          , Gs          , Gs          , Gs          , Rp          , Rp          , Gs          , Rp          , Chr         , Rp          , Gs          , Gs          , Gs          , Gs          , Gs          , Gs          , Ww          , Gs          , Gs          , Hh          , Rd          , Rd          , Ha          , Ms          , Ms          , Ms          , Ms          , Ms          , Ms          , Ms          , Ms          , Ms^Xm       , Ms^Xm       , Ms^Xm       , Ms^Xm       , Ms^Xm       , Ms^Xm       
Gs^Fds      , Gll^Fmf     , Gs          , Gs          , Ce          , Rd          , Rb          , Rd          , Gll^Fmf     , Rd          , Rd          , Gs          , Rp          , Rp          , Gs          , Gs          , Gs          , Gs          , Gs          , Rp          , Rp          , Gs          , Gs          , Gs          , Gs          , Gs          , Ww          , Gs          , Gs          , Hh          , Rd          , Rd          , Ms          , Ha          , Ha          , Ms          , Ha^Vhha     , Ms          , Ms          , Ms          , Ms          , Ms^Xm       , Ms^Xm       , Ms^Xm       , Ms^Xm       , Ms^Xm       , Ms^Xm       
Gg          , Gg^Fet      , Gs          , Ce          , 1 Ke        , Ce          , Re          , Gll^Fmf     , Gg^Ve       , Gll^Fmf     , Gll^Fmf     , Rp          , Gs          , Gs          , Gs^Vh       , Gs          , Gs          , Gs          , Gs          , Gs          , Gs          , Rp          , Rp          , Gs          , Gs          , Wwt         , Gs          , Gs          , Gs          , Hh          , Hh          , Rd          , Rd          , Ha          , Ms          , Ha          , Ha          , Ms          , Ms          , Ms          , Ms          , Ms          , Ms^Xm       , Ms^Xm       , Ms^Xm       , Ms^Xm       , Ms^Xm       
Gg          , Gs          , Rb          , Ce          , Ce          , Ce          , Re          , Gll^Fmf     , Gll^Fmf     , Gd^Fdf      , Gll^Fmf     , Gs          , Gs          , Gs          , Gs          , Gs          , Gs          , Gs          , Gs          , Gs          , Gs          , Gs          , Gs          , Rp          , Wwt^Bw\     , Wwt         , Gs          , Gs          , Gs          , Hh          , Rd          , Rd          , Hhd         , Rd          , Rd          , Hhd         , Ms          , Ha          , Ms          , Ms          , Ms          , Ms          , Ms          , Ms^Xm       , Ms          , Ms^Xm       , Ms          
Gs^Fds      , Gg^Fet      , Gll^Fmf     , Re          , Re          , Re          , Gll^Fmf     , Gll^Fmf     , Gll^Fmf     , Gd^Fdf      , Gll^Fmf     , Gll^Fmf     , Gs          , Gs          , Gs          , Gs          , Gs          , Gs          , Gs          , Gs          , Gs          , Gs^Vh       , Gs          , Gs          , Wwt         , Rd          , Rd          , 2 Rd        , Rd          , Rd          , Hh          , Hhd         , Hh          , Hh^Vhh      , Hhd         , Rd          , Rd          , Ha          , Ha          , Ha^Vhha     , Ms          , Ms          , Ms          , Ms          , Ms          , Ms          , Ms          
Gs^Fds      , Gs^Fds      , Gll^Fmf     , Gll^Fmf     , Gll^Fmf     , Gll^Fmf     , Gll^Fmf     , Gll^Fmf     , Gll^Fmf     , Gll^Fmf     , Gll^Fmf     , Gll^Fmf     , Gs          , Gs          , Gs          , Gs          , Gs          , Gs          , Gs          , Gs          , Gs          , Gs          , Gs          , Wwt         , Wwt         , Gs          , Gs          , Gs          , Gs          , Gs          , Gs          , Hh          , Hh          , Hh          , Hh          , Rb          , Rd          , Hhd         , Hhd         , Ha          , Ha          , Ha          , Ha          , Ms          , Ms          , Ms          , Ms          
Gll^Fmf     , Gll^Fmf     , Gd^Fmw      , Gll^Fmf     , Gll^Fmf     , Gg^Ve       , Gll^Fmf     , Gll^Fp      , Gd^Fdf      , Gd^Fmw      , Gll^Fmf     , Gll^Fmf     , Gs          , Gs          , Gs          , Gs          , Gs          , Gs          , Gs          , Gs          , Gs          , Gs          , Wwt         , Wwt         , Gs          , Gs          , Gs          , Gs          , Gs          , Gs          , Gs          , Gs          , Gs          , Hh          , Hh          , Hh          , Hh          , Rd          , Rd          , Hhd         , Rd          , Hhd         , Ha          , Ms          , Ha          , Ha^Vhha     , Ha          
Gll^Fmf     , Gll^Fp      , Gll^Fmf     , Gll^Fmf     , Gll^Fp      , Gll^Fmf     , Gll^Fmf     , Gll^Fmf     , Gll^Fmf     , Gd^Fmw      , Gll^Fmf     , Gll^Fmf     , Gs          , Gs          , Gs          , Gs          , Gs          , Gs          , Gs          , Gs          , Gs          , Gs          , Wwt         , Gs          , Gs          , Gs          , Gs          , Gs          , Gs          , Gs          , Gs          , Gs          , Gs          , Gs          , Gs          , Hh          , Hh          , Hhd         , Hhd         , Rb          , Hhd         , Rd          , Rd          , Ha          , Rd          , Ha          , Hhd         
Gll^Fmf     , Gg^Ve       , Gll^Fmf     , Gll^Fmf     , Gll^Fmf     , Gll^Fmf     , Gll^Fmf     , Gd^Fdf      , Gll^Fmf     , Gll^Fmf     , Gd^Fmw      , Gd^Fmw      , Gs          , Gs          , Gs          , Gs          , Gs          , Gs          , Gs          , Gs          , Gs          , Gs          , Gs          , Wwt         , Gs          , Gs          , Gs          , Gs          , Gs          , Gs          , Gs          , Gs          , Gs          , Gs          , Gs          , Gs          , Hh          , Hh          , Hh          , Hh          , Hh          , Hhd         , Hh          , Rb          , Hhd         , Rd          , Rd          
Gll^Fmf     , Gll^Fmf     , Gll^Fmf     , Gll^Fmf     , Gll^Fmf     , Gll^Fmf     , Gll^Fmf     , Gll^Fmf     , Gll^Fmf     , Gd^Fmw      , Gll^Fmf     , Gs          , Gs          , Gs          , Gs          , Gs          , Gs          , Gs          , Gs          , Gs          , Gs          , Gs          , Gs          , Wwt         , Wwt         , Gs          , Gs          , Gs          , Gs          , Gs          , Gs          , Gs          , Gs          , Gs          , Gs          , Gs          , Gs          , Gs          , Gs          , Gs          , Gs          , Hh          , Hh          , Hhd         , Hhd         , Hhd         , Hhd         
