border_size=1
usage=map

Xuc, Xuc, Xuc, Xuc, Xuc, Xuc, Xuc, Xuc, Xuc, Xuc, Xuc, Xuc, Xuc, Xuc, Xuc, Xuc, Xuc, Xuc, Xuc, Xuc, Xuc, Xuc, Xuc, Xuc, Xuc, Xuc, Xuc, Xuc, Xuc, Xuc, Xu, Xu, Xu, Xu, Xu, Xu, Qlf, Xu, Xu, Xu, Xol, Xol, Ww, Xol, Xol, Xu, Xu, Xu, Xu, Xu, Xol, Xos, Xol, Xu, Xu, Xu, Xu, Xu, Xu, Xu, Xos, Xol, Xos, Xu, Xu, Xu, Xu, Xu
Xuc, Xuc, Xuc, Xuc, Xuc, Xuc, Xuc, Xuc, Xuc, Xuc, Xuc, Xuc, Xuc, Xuc, Xuc, Xuc, Xuc, Xuc, Xuc, Xuc, Uh, Uh, Uh, Uh, Uh, Uh, Uh, Xuc, Xuc, Xuc, Xuc, Xu, Xu, Xu, Xu, Xu, Qlf, Xu, Xol, Xol, Gd^Fdf, Wwr, Ur, Gd^Fdf, Iwr, Xol, Xol, Xu, Xol, Xol, Urb, Urb, Urb, Xol, Xol, Xu, Xu, Xu, Xos, Xos, Urb, Urb, Urb, Xos, Xos, Xu, Xu, Xu
Uu^Ii, Xuc, Xuc, Xuc, Xuc, Xuc, Xuc, Xuc, Xuc, Xuc, Xuc, Xuc, Xuc, Xuc, Xuc, Xuc, Xuc, Xuc, Xuc, Xuc, Uh, Uh, Uue, Uu^Vud, Uue, Uu, Uue, Uue, Qxu^Bs\, Xuc, Xuc, Xuc, Xuc, Xu, Xu, Xu, Ql, Xol, Xol, Iwr, Iwr, Ur^Ii, Iwr, Iwr, Xol, Iwr, Urb, Xol, Urb, Urb, Urb, Urb, Urb, Urb, Urb, Xol, Xos, Xos, Urb, Urb, Urb, Urb, Urb, Urb, Urb, Xos, Xos, Xu
Uu^Ii, Uu^Ii, Uue, Xuc, Uh, Xuc, Xuc, Xuc, Xuc, Xuc, Xuc, Xuc, Xuc, Xuc, Xuc, Xuc, Xuc, Xuc, Xuc, Xuc, Uh, Uu^Vud, Uue, Uue, Uu, Uue, Xu, Xu, Xu, Qxu^Bs\, Qxu^Bs\, Xuc, Xuc, Xuc, Xuc, Xol, Xos, Ur, Iwr, Iwr, Xol, Iwr, Xol, Xol, Xu, Xol, Xol, Urb, Urb, Urb, Urb, Urb, Urb, Urb, Xol, Urb, Urb, Urb, Urb, Urb, Urb, Urb, Urb, Urb, Urb, Urb, Urb, Xol
Xuc, Uu, Uue, Uu, Uue, Uu, Uu, Xuc, Xuc, Xuc, Xuc, Xuc, Xuc, Xuc, Xuc, Xuc, Xuc, Xuc, Xuc, Uh, Uu, Uu, Uue, Uu, Xuc, Xuc, Xu, Xu, Xu, Xu, Xu, Uu, Xu, Xuc, Xuc, Xol, Xol, Iwr, Iwr, Iwr, Xol, Xol, Xu, Xu, Xu, Xu, Xu, Xol, Xol, Urb, Urb, Urb, Xol, Xol, Xu, Xol, Xol, Urb, Urb, Urb, Urb, Urb, Urb, Urb, Urb, Urb, Urb, Xol
Xuc, Xuc, Uh, Uue, Uue, 1 Uue, Uue, Uu, Uu, Xuc, Xuce, Xuc, Xuc, Xuc, Xuc, Xuc, Xuc, Xuc, Xuc, Xuc, Uu^Vud, Uue, Uu, Xuc, Xuc, Xuc, Xuc, Xu, Xu, Xu, Xu, Uu, Xu, Xu, Xu, Xu, Xu, Xol, Xol, Xol, Xuc, Xuc, Xuc, Xu, Xu, Xu, Xu, Xu, Xu, Xol, Xol, Xol, Xu, Xu, Xu, Xu, Xu, Xol, Xol, Urb, Urb, Urb, Urb, Urb, Urb, Urb, Urb, Xol
Xuc, Xuc, Xuc, Uu, Uu, Uue, Uu, Uue, Uue, Uu, Qxe, Xuce, Xuce, Xuc, Xuc, Xuc, Xuc, Xuc, Xuc, Xuc, Xuc, Uue, Uu, Uu, Uu, Uh, Uu, Uh, Xuc, Xu, Xu, Uu, Uu, Xu, Xu, Xu, Xu, Xuc, Xuc, Xuc, Xuc, Xuc, Xuc, Xuc, Xuc, Xu, Xu, Xu, Xu, Xu, Xu, Xu, Xu, Xu, Xu, Xu, Xu, Xu, Xu, Xol, Xol, Urb, Urb, Urb, Urb, Urb, Uu, Xol
Xuc, Xuc, Xuc, Xuc, Xuc, Uu, Uu, Uue, Qxu^Bs\, Qxu^Bs\, Qxu^Bs\, Qxe, Qxe, Xuce, Xuce, Xuce, Uu^Xo, Uu^Vud, Ur, Xuc, Xuc, Xuc, Xuc, Uu, Uu, Uu, Uu, Uu, Xuc, Xuc, Xuc, Xu, Xu, Uu, Uu, Xu, Xu, Xu, Xu, Xuc, Xuc, Xuc, Xuc, Xuc, Xuc, Xuc, Xuc, Xu, Xu, Xu, Xu, Xu, Xu, Xu, Xu, Xu, Xu, Xu, Xu, Xu, Uu^Ufi, Xol, Uu, Urb, Xol, Xol, Xu, Uu
Xuc, Xuc, Xuc, Xuc, Xuc, Xuce, Xuce, Qxe, Qxe, Qxu^Bs\, Qxu^Bs\, Qxu^Bs\, Uu, Cud, Cud, Kud, Xuc, Xuc, Xuc, Ur, Uu, Xuc, Xuc, Xuc, Xuc, Xu, Uu, Uu, Xu, Xuc, Xuc, Xuc, Xu, Xu, Xu, Uu, Xu, Xu, Xuc, Xuc, Xuc, Xuc, Xuc, Xuc, Xuc, Xuc, Xuc, Xuc, Xuc, Xu, Xu, Xu, Xu, Xu, Xu, Xu, Xu, Xu, Xu, Xu, Uu, Uu^Ii, Uu^Ii, Xol, Xol, Xu, Xu, Xu
Xuc, Xuc, Xuc, Xuc, Xuc, Xuc, Xuc, Xuce, Xuce, Qxe, Cud, Uu, Ur, Ur, Ur, Cud, Cud, Xuc, Xuc, Xuc, Xuc, Uu, Ur, Xuc, Xuc, Xuc, Uu, Uu, Uu, Xu, Uu, Xuc, Xuc, Xu, Xu, Uu, Xu, Xu, Xuc, Xuc, Xuc, Xuc, Xuc, Xuc, Xuc, Xuc, Xuc, Xuc, Xuc, Xuc, Xu, Xu, Ur, Ur, Ur, Xu, Xu, Xu, Ur, Uu, Xu, Xu, Xu, Uu^Ufi, Xu, Xu, Xu, Xu
Xuc, Xuc, Xuc, Xuc, Xuc, Xuc, Xuc, Xuc, Xuc, Xuc, Xuc, Cud, Cud, Uu, Ur, Ur, Ur, Uue, Uu^Vud, Xuc, Xuc, Xuc, Xuc, Uu, Xuc, Xuc, Xu, Uu, Uu, Uu, Uu^Vud, Uu, Xuc, Xuc, Xuc, Uu, Uu, Xu, Xu, Xuc, Xuc, Xuc, Xuc, Xuc, Xuc, Xuc, Xuc, Xuc, Xu, Xu, Uu, Uu, Xu, Xu, Xu, Xue, Uu, Ur, Xu, Xu, Xu, Xu, Xu, Xu, Xu, Xu, Xu, Xu
Xuc, Xuc, Xuc, Xuc, Xuc, Xuc, Xuc, Xuc, Xuc, Xuc, Uu^Xo, Kud, Xuc, Cud, Uue, Uu, Uu, Ur, Ur, Uu, Uu^Vud, Xuc, Xuc, Ur, Xuc, Xuc, Xu, Uu, Uu^Vud, Ur, Uu, Uu, Uh, Xuc, Xuc, Xuc, Uu, Xu, Xu, Xu, Xu, Xuc, Xuc, Xuc, Xuc, Xuc, Xu, Xu, Uu, Ur, Xu, Xu, Xu, Xu, Uu, Uu, Xu, Xu, Xu, Xu, Xu, Xu, Xu, Xu, Xu, Xu, Xu, Xu
Xuc, Xuc, Xuc, Xuc, Xuc, Xuc, Xuc, Xuc, Ur, Uu^Vud, Xuc, Xuc, Xuc, Xuc, Xuc, Uu^Vud, Uu, Ur, Ur, Uu, Uue, Xuc, Xuc, Ur, Xuc, Xuc, Xu, Uu, Uu, Ur, Uu^Vud, Uu, Uu, Xuc, Xuc, Xuc, Uu, Xuc, Xu, Xu, Xu, Xu, Xuc, Xuc, Xu, Xu, Uu, Ur, Xu, Xu, Xu, Xu, Xu, Xu, Uu, Uu, Xu, Xu, Xu, Xu, Xu, Xu, Xu, Xu, Xu, Xu, Xu, Xu
Xuc, Xuc, Xuc, Xuc, Xuc, Xuc, Xuc, Ur, Xuc, Xuc, Xuc, Xuc, Xuc, Xuc, Xuc, Xuc, Xuc, Uu^Vud, Ur, Ur, Uue, Xuc, Xuc, Uu, Xuc, Xuc, Xu, Xu, Uu, Ur, Uu, Uu, Xuc, Xuc, Xuc, Xuc, Uu, Xu, Xu, Xu, Xu, Xu, Xu, Xu, Ur, Ur, Xu, Xu, Xu, Xu, Xu, Xu, Xu, Uu^Uf, Uu, Uu, Xu, Xu, Xu, Xu, Xu, Xu, Xu, Xu, Xu, Xu, Xu, Xu
Xuc, Xuc, Xuc, Xuc, Xuc, Xuc, Xuc, Ur, Xuc, Xuc, Xuc, Xuc, Xuc, Xuc, Xuc, Xuc, Xuc, Xuc, Ur, Uu, Uue, Xuc, Xuc, Ur, Xuc, Xuc, Xu, Uu, Uu^Vud, Ur, Uu, Uh, Xuc, Xuc, Xu, Xu, Uu, Xu, Xu, Xu, Xu, Xu, Ur, Uu, Xu, Xu, Xu, Xu, Cud, Xu, Xu, Xu, Xu, Xu, Xu, Uu, Uu, Xu, Uu^Uf, Xu, Xu, Xu, Xu, Xu, Xu, Xu, Xu, Xu
Xuc, Xuc, Xuc, Xuc, Xuc, Xuc, Urb, Urb, Urb, Xuc, Cud, Xuc, Cud, Xuc, Cud, Xuc, Uu, Ur, Uu, Uu, Xuc, Xuc, Xuc, Uu, Xuc, Xuc, Xuc, Uu, Uu, Ur, Xuc, Xuc, Xu, Xu, Qxu, Uu, Qxu, Xu, Xu, Xu, Uu, Ur, Xu, Xu, Xu, Xu, Xu, Cud, Uu, Cud, Uu, Xu, Xu, Xu, Xu, Uu^Emf, Uu, Uu, Uu^Emf, Xu, Xu, Xu, Xu, Xu, Xu, Xu, Xu, Xu
Xuc, Xuc, Xuc, Xuc, Urb, Urb, Uu^Vud, Urb, Urb, Urb, Urb, Urb, Urb, Urb, Ur, Ur, Ur, Ur, Xuc, Xuc, Xuc, Xuc, Uu, Ur, Xuc, Xuc, Xuc, Xuc, Uu, Ur, Xuc, Xuc, Xuc, Xu, Qxu, Uu, Qxu^Bs\, Qxu, Qxu, Uu, Xu, Xu, Xu, Xu, Xu, Xu, Uu, Uu, Uu, Uu, Uu, Uu, Uu, Uu, Uu, Uu, Xu, Uu, Xu, Xu, Xu, Xu, Xu, Xu, Xu, Xu, Xuc, Xuc
Xuc, Xuc, Urb, Urb, Uu^Vud, Urb, Urb, Urb, Urb, Urb, Urb, Urb, Urb, Urb, Cud, Ur, Xuc, Xuc, Xuc, Xuc, Ur, Uu, Xuc, Xuc, Xuc, Xuc, Xuc, Xuc, Ur, Ur, Xuc, Xuc, Xuc, Xuc, Xuc, Qxu, Qxu, Uu, Qxu^Bs\, Qxu, Xu, Xu, Xu, Xu, Xu, Xu, Uu, Uu, Uu, Uu, Uu, Uu, Uu, Xu, Xu, Xu, Xu, Xu, Xu, Xu, Xu, Xu, Xu, Xu, Xuc, Xuc, Xuc, Xuc
Xuc, Urb, Uu^Vud, Urb, Urb, Urb, Cud, Cud, Urb, Urb, Urb, Urb, Urb, Urb, Xuc, Xuc, Xuc, Xuc, Uu, Ur, Xuc, Xuc, Xuc, Xuc, Xuc, Xuc, Xuc, Xuc, Ur, Uu, Xuc, Xuc, Xuc, Xuc, Xuc, Xuc, Xuc, Qxu, Qxu, Uu, Xu, Xu, Xu, Xu, Xu, Xu, Xu, Uu, Uu, Uu, Uu, Uu, Xu, Xu, Xu, Xu, Xu, Xu, Xu, Xu, Xu, Xu, Xuc, Xuc, Xuc, Xuc, Xuc, Xuc
Xuc, Urb, Urb, Urb, Cud, Cud, Cud, Cud, Urb, Urb, Urb, Urb, Urb, Urb, Xuc, Xuc, Uu, Uu, Xuc, Xuc, Xuc, Xuc, Xuc, Xuc, Xuc, Xuc, Xuc, Xuc, Ur, Uu, Xuc, Xuc, Xuc, Xuc, Xuc, Xuc, Xuc, Qxu, Qxu, Qxu^Bs|, Xu, Xu, Xu, Xu, Xu, Xu, Xu, Uu^Ii, Uu^Ii, Uu, Uu, Uu, Xu, Xu, Xu, Xu, Xu, Xu, Xu, Xu, Xuc, Xuc, Xuc, Xuc, Xuc, Xuc, Xuc, Xuc
Xuc, Urb, Uu^Vud, Urb, Cud, Cud, Cud, Cud, Urb, Urb, Urb, Urb, Urb, Urb, Ur, Ur, Xuc, Xuc, Xuc, Xuc, Xuc, Xuc, Xuc, Uu, Uu, Uu, Ur, Ur, Uu, Uu, Xuc, Xuc, Xuc, Xuc, Xuc, Xuc, Xu, Xu, Qxu, Uu, Xu, Xu, Xu, Xu, Xu, Xu, Uu^Vud, Uu^Ii, Xu, Uu^Ii, Xu, Uu, Xu, Xu, Xu, Xu, Xu, Xu, Xu, Xuc, Xuc, Xuc, Xuc, Xuc, Xuc, Xuc, Xuc, Xuc
Xuc, Urb, Urb, Urb, Cud, 2 Cud, Cud, Cud, Urb, Urb, Urb, Urb, Urb, Urb, Xuc, Xuc, Xuc, Xuc, Xuc, Xuc, Xuc, Xuc, Xuc, Xuc, Uu, Uu, Ur, Uu, Xuc, Xuc, Xuc, Xuc, Xuc, Xuc, Xuc, Xuc, Xu, Xu, Qxu, Qxu^Bs|, Qxu, Xu, Xu, Xu, Xu, Uu, Xu, Xu, Xu, Xu, Xu, Xu, Xu, Xu, Xu, Xu, Xu, Xu, Xu, Xuc, Xuc, Xuc, Xuc, Xuc, Xuc, Xuc, Xuc, Xuc
Xuc, Urb, Uu^Vud, Urb, Cud, Kud, Cud, Cud, Urb, Urb, Urb, Urb, Urb, Urb, Cud, Xuc, Xuc, Xuc, Uu, Uh, Uu, Xuc, Uu, Uu, Ur, Ur, Ur, Uu, Ur, Xuc, Uu, Xuc, Xuc, Xuc, Xuc, Xuc, Xu, Qxu, Qxu, Uu, Qxu^Bs\, Qxu, Qxu, Xu, Uu^Dr, Uu, Xu, Xu, Xu, Xu, Xu, Xu, Xu, Xu, Xu, Xu, Xu, Xu, Xu, Xuc, Xuc, Xuc, Xuc, Xuc, Xuc, Xuc, Xuc, Xuc
Xuc, Urb, Urb, Urb, Cud, Cud, Cud, Cud, Urb, Urb, Urb, Urb, Urb, Urb, Ur, Xuc, Ur, Ur, Ur, Ur, Ur, Uu, Ur, Ur, Xuc, Xuc, Xuc, Ur, Uu, Ur, Ur, Xuc, Xuc, Xuc, Xuc, Xuc, Xu, Qxu, Qxu, Qxu, Qxu, Qxu^Bs\, Qxu^Bs\, Qxu^Es, Qxu, Xu, Xu, Xu, Xu, Xu, Xu, Xu, Xu, Xu, Xu, Xu, Xu, Xu, Xuc, Xuc, Xuc, Xuc, Xuc, Xuc, Xuc, Xuc, Xuc, Xuc
Xuc, Urb, Uu^Vud, Urb, Urb, Cud, Cud, Cud, Urb, Urb, Urb, Urb, Urb, Urb, Ur, Ur, Uu, Uu, Xuc, Xuc, Xuc, Ur, Ur, Uu, Uue, Xuc, Xuc, Xuc, Xuc, Uu, Uu, Ur, Uu, Uu, Uu, Xuc, Xuc, Xu, Xu, Xu, Xu, Qxu, Qxu, Qxu^Bs\, Qxu^Bs\, Qxu, Qxu, Xu, Xu, Xu, Xu, Xu, Xu, Xu, Xu, Xu, Xuc, Xuc, Xuc, Xuc, Xuc, Xuc, Xuc, Xuc, Xuc, Xuc, Xuc, Xuc
Xuc, Urb, Urb, Urb, Uu^Vud, Urb, Urb, Cud, Urb, Urb, Urb, Urb, Urb, Urb, Cud, Uu, Xuc, Xuc, Xuc, Xuc, Xuc, Xuc, Ur, Uu, Uue, Xu, Xuc, Xuc, Xuc, Xuc, Uu, Ur, Uu, Uu, Uu, Xuc, Xuc, Xuc, Xuc, Xu, Xu, Xu, Xu, Qxu, Qxu, Uu, Qxu^Bs\, Qxu, Qxu, Xu, Xu, Xu, Xu, Xu, Xuc, Xuc, Xuc, Xuc, Xuc, Xuc, Xuc, Xuc, Xuc, Xuc, Xuc, Xuc, Xuc, Xuc
Xuc, Urb, Urb, Urb, Urb, Urb, Uu^Vud, Urb, Urb, Urb, Urb, Urb, Cud, Xuc, Xuc, Xuc, Xuc, Xuc, Xuc, Xuc, Uu^Emf, Uu, Ur, Uu, Xuc, Xuc, Xuc, Xuc, Uh, Uu, Uu^Vud, Ur, Ur, Uu^Vud, Uu, Xu, Uu, Xuc, Xu, Xuc, Xuc, Xu, Xu, Xu, Xu, Qxu, Qxu, Qxu^Bs\, Qxu^Bs\, Qxu, Xu, Xu, Xu, Xuc, Xuc, Xuc, Xuc, Xuc, Xuc, Xuc, Xuc, Xuc, Xuc, Xuc, Xuc, Xuc, Xuc, Xuc
Xuc, Xuc, Xuc, Urb, Urb, Urb, Urb, Urb, Urb, Urb, Cud, Xuc, Xuc, Xuc, Xuc, Xuc, Xuc, Xuc, Uu^Uf, Uu^Emf, Uu^Uf, Uu^Uf, Uu^Ii, Xuc, Xuc, Xuc, Xuc, Xuc, Uh, Uu, Uu, Uu, Uu, Ur, Ur, Uu, Uu^Vud, Uu, Uh, Xuc, Xuc, Xuc, Xuc, Xu, Xu, Xu, Xu, Qxu, Xu, Uu, Qxu^Bs\, Qxu, Qxu, Xu, Xu, Xuc, Xuc, Xuc, Xuc, Xuc, Xuc, Xuc, Xuc, Xuc, Xuc, Xuc, Xuc, Xuc
Xuc, Xuc, Xuc, Xuc, Xuc, Urb, Urb, Urb, Urb, Urb, Xuce, Xuce, Xuce, Xuc, Xuc, Xuc, Uu^Ii, Uu^Uf, Uu^Uf, Uu^Uf, Uu^Ii, Uu^Emf, Uu^Uf, Uu^Emf, Uu^Uf, Xuc, Xuc, Xuc, Xuc, Uu, Uu, Uu, Uu, Uu^Vud, Uu, Ur, Ur, Uu, Xuc, Xuc, Xuc, Xuc, Xuc, Xuc, Xuc, Xu, Xu, Xu, Xu, Qxu, Qxu, Qxu^Bs\, Qxu^Bs\, Qxu, Qxu, Xu, Xu, Xuc, Xuc, Xuc, Xuc, Xuc, Xuc, Xuc, Xuc, Xuc, Xuc, Xuc
Xuc, Xuc, Xuc, Xuc, Xuc, Xuc, Xuc, Cud, Xuce, Urb^Xo, Urb, Urb, Urb, Xuce, Xuce, Xuc, Xuc, Uu^Emf, Uu^Uf, Uu^Uf, Uu^Uf, Uu^Uf, Uu^Uf, Uu^Uf, Uu^Ii, Uu^Uf, Uu^Uf, Xuc, Xuc, Xuc, Xuc, Uu, Uu, Uu, Uu, Uu, Uu, Ur, Uu, Xuc, Xuc, Xuc, Uh, Xuc, Uu, Xuc, Xuc, Xu, Xu, Xu, Xu, Qxu, Qxu, Qxu^Bs\, Uu, Qxu, Xu, Xu, Xuc, Xuc, Xuc, Xuc, Xuc, Xuc, Xuc, Xuc, Xuc, Xuc
Xuc, Xuc, Xuce, Xuc, Xuc, Xuc, Xuce, Xuce, Urb, Urb, Urb, Urb, Urb, Urb, Urb, Xuce, Xuce, Xuc, Xuc, Uu^Emf, Uu^Ufi, Uu^Emf, Uu^Uf, Uu^Uf, Uu^Uf, Uu^Uf, Uu^Uf, Uu^Emf, Uu^Emf, Xuc, Uu, Uu, Xuc, Uu, Xuc, Xuc, Xuc, Ur, Ur, Uu, Uu, Uu, Uu, Uu, Uu, Xuc, Xuc, Xuc, Xuc, Xuc, Xu, Xu, Xu, Qxu, Xu, Uu, Uu, Xu, Xuc, Xuc, Xuc, Xuc, Xuc, Xuc, Xuc, Xuc, Xuc, Xuc
Xuc, Xuce, Xuce, Xuce, Xuce, Xuc, Xuce, Urb, Urb, Urb, Urb, Urb, Urb, Urb, Urb, Urb, Xuce, Xuc, Xuc, Xuc, Xuc, Uu^Uf, Uu^Ii, Uu^Uf, Uu^Emf, Uu^Emf, Uu^Ii, Uu^Uf, Uu^Emf, Uu^Ufi, Xuc, Xuc, Xuc, Xuc, Xuc, Xuc, Xuc, Xuc, Uu, Ur, Ur, Uu^Vud, Uu, Uu^Vud, Uu, Uh, Xuc, Xuc, Xuc, Xuc, Xuc, Xu, Xu, Xu, Xu, Xu, Xu, Uu, Uu, Xuc, Xuc, Xuc, Xuc, Xuc, Xuc, Xuc, Xuc, Xuc
Xuc, Xuc, Xuc, Xuce, Xuce, Xuce, Xuce, Xuce, Xuce, Urb, Urb, Urb, Urb, Urb, Xuce, Xuce, Xuc, Xuc, Xuc, Xuc, Xuc, Xuc, Xuc, Uu^Uf, Uu^Uf, Uu^Uf, Uu^Uf, Uu^Uf, Xuc, Xuc, Xuc, Xuc, Xuc, Xuc, Uu, Uu, Uu, Uu, Xuc, Xuc, Xuc, Ur, Ur, Ur, Ur, Uu, Xuc, Xuc, Xuc, Xuc, Xuc, Xuc, Xuc, Xu, Xu, Xu, Xu, Xu, Xu, Uu, Uu, Xuc, Xuc, Xuc, Xuc, Xuc, Xuc, Xuc
Xuc, Xuc, Xuc, Xuc, Xuc, Xuce, Xuce, Xuce, Xuce, Xuce, Xuce, Urb, Xuce, Xuce, Xuc, Xuc, Xuc, Xuc, Xuc, Xuc, Xuc, Xuc, Xuc, Xuc, Xuc, Uu^Uf, Xuc, Xuc, Xuc, Xuc, Xuc, Xuc, Uu, Uu, Uu^Vud, Uu, Uu^Vud, Uu, Uu, Xuc, Xuc, Xuc, Xuc, Uu, Ur, Uu, Xuc, Xuc, Xuc, Xuc, Xuc, Xuc, Xuc, Xuc, Xuc, Xuc, Xuc, Xuc, Xuc, Xu, Xu, Uu, Uu, Xuc, Xuc, Xuc, Xuc, Xuc
Xuc, Xuc, Xuc, Xuc, Xuc, Xuc, Xuc, Xuce, Xuc, Xuc, Xuc, Xuce, Xuc, Xuc, Xuc, Xuc, Xuc, Xuc, Xuc, Xuc, Xuc, Xuc, Xuc, Xuc, Xuc, Xuc, Xuc, Xuc, Xuc, Xuc, Uu, Uu, Uu, Uu, Uu, Uu, Uu, Uu, Xuc, Xuc, Xuc, Xuc, Xuc, Xuc, Ur, Uu, Xuc, Xu, Xu, Xu, Xu, Xu, Xu, Xu, Xu, Xu, Xu, Xu, Xu, Xu, Xu, Xu, Xu, Uu, Uu, Xu, Xu, Xu