border_size=1
usage=map

Hh          , Hh          , Hh          , Hh          , Hh          , Rr          , Rr          , Hh          , Hh          , Hh          , Hh          , Hh          , Hh          , Hh          , Hh          , Hh          , Hh          , Hh          , Hh          , Hh          , Hh          , Hhd         , Hhd         , Hhd         , Md          , Md          , Md          , Md          , Md          , Md          , Md          , Md          , Md          , Md          , Md          , Md          , Md          , Md          , Md          , Md          , Md          , Md          , Md          , Md          , Md          , Md          
Mm          , Hh          , Hh^Fp       , Hh^Fp       , Hh          , Hh          , Hh          , Rr          , 1 Rr        , Hh          , Gg^Gvs      , Gg^Gvs      , Gg^Gvs      , Gg^Gvs      , Gg^Gvs      , Hh          , Gg          , Hh          , Hh          , Hh          , Hhd         , Hhd         , Hhd         , Hhd         , Md          , Md          , Md          , Md          , Md          , Md          , Md          , Md          , Md          , Md          , Md          , Md          , Md          , Md          , Md          , Md          , Md          , Md          , Md          , Md          , Md          , Md          
Mm          , Hh          , Hh          , Hh^Fp       , Hh^Fp       , Hh          , Hh^Fp       , Hh          , Gg^Gvs      , Rr          , Rr          , Gg^Gvs      , Gg^Gvs      , Gg^Gvs      , Gg^Gvs      , Gg^Gvs      , Gg^Gvs      , Hh          , Hh          , Hh          , Hh          , Hhd         , Hhd         , Hhd         , Md          , Md          , Md          , Md          , Md          , Md          , Md          , Md          , Md          , Md          , Md          , Md          , Md          , Md          , Md          , Md          , Md          , Md          , Md          , Md          , Md          , Md          
Mm          , Mm          , Hh          , Hh^Fp       , Hh^Fds      , Hh^Fp       , Hh^Fp       , Hh          , Gg^Gvs      , Gg^Gvs      , Gg^Gvs      , Rr          , Rr          , Gg^Gvs      , Gg^Gvs      , Gg^Gvs      , Gg          , Gg          , Gg          , Hh          , Hh          , Hh          , Hhd         , Hhd         , Md          , Md          , Md          , Md          , Md          , Md          , Md          , Md          , Md          , Md          , Md          , Md          , Md          , Md          , Md          , Md          , Md          , Md          , Md          , Md          , Md          , Md          
Mm          , Mm          , Hh          , Hh          , Hh^Fds      , Hh^Fds      , Hh^Fp       , Hh^Fp       , Gg^Gvs      , Gg^Gvs      , Gg^Gvs      , Gg^Gvs      , Gg^Gvs      , Rr          , Gg          , Gg          , Gs          , 5 Gs        , Gs          , Gg          , Hh          , Hh          , Hhd         , Hhd         , Hhd         , Md          , Md          , Md          , Hhd         , Hhd         , Md          , Md          , Md          , Md          , Md          , Md          , Md          , Md          , Md          , Md          , Md          , Md          , Md          , Md          , Md          , Md          
Hh^Fds      , Hh^Fds      , Hh^Fds      , Hh^Fds      , Hh^Fds      , Hh^Fp       , Gs^Fds      , Gs^Fds      , Gg^Gvs      , Gg^Gvs      , Gg^Gvs      , Gg^Gvs      , Gg^Gvs      , Rr          , Gg^Gvs      , Gg          , Gs          , Gs          , Gs          , Gg          , Gg          , Hh          , Hh          , Hhd         , Hhd         , Hhd         , Hhd         , Hhd         , Hhd         , Md          , Md          , Md          , Md          , Md          , Md          , Md          , Md          , Md          , Md          , Md          , Md          , Md          , Md          , Md          , Md          , Md          
Hh^Fp       , Hh^Fp       , Gs^Fms      , Hh^Fds      , Gs^Fms      , Gs^Fms      , Gs^Fds      , Gs^Fds      , Gs^Fds      , Gg^Gvs      , Gg^Gvs      , Gg^Gvs      , Gg^Gvs      , Rr          , Gg^Gvs      , Gg^Gvs      , Gg^Gvs      , Gg          , Gg          , Gg          , Gg          , Gg          , Hh          , Hhd         , Hh          , Hhd         , Hh          , Hh          , Hh          , Md          , Md          , Md          , Md          , Md          , Md          , Md          , Hhd^Dr      , Md          , Hhd^Dr      , Hhd^Dr      , Md          , Md          , Md          , Md          , Md          , Md          
Hh^Fp       , Hh^Fp       , Gs^Fms      , Gs^Fms      , Gs^Fms      , Gs^Fms      , Gs^Fms      , Gs^Fds      , Gs^Fds      , Gll^Fp      , Gs^Fds      , Gg^Gvs      , Gg^Gvs      , Rr          , Gg^Gvs      , Gg^Gvs      , Gg^Gvs      , Gg^Gvs      , Gg          , Gs          , Gs          , Gg          , Gg          , Hh          , Gg          , Hh          , Hh          , Hh          , Hh          , Md          , Md          , Md          , Md          , Md          , Hh^Vhh      , Hhd^Dr      , Hhd         , Hhd^Dr      , Hhd         , Hhd         , Md          , Md          , Md          , Md          , Md          , Md          
Hh^Fp       , Hh^Fp       , Gs^Fms      , Gs^Fms      , Gll^Fp      , Gs^Fms      , Gs^Fms      , Gs^Fms      , Gs^Fds      , Gs^Fds      , Gs^Fds      , Gll^Fp      , Gg^Gvs      , Rr          , Gs^Vh       , Gg^Gvs      , Gg^Gvs      , Gg^Gvs      , Gg          , Gg          , Gg          , Gg          , Gg          , Gg          , Gg          , Gg          , Gs          , Hh          , Hh          , Hh          , Hh          , Md          , Hhd         , Hhd         , Hhd^Dr      , Re          , Re          , Hhd         , Re          , Hh^Vhh      , Md          , Md          , Md          , Md          , Md          , Md          
Hh^Fp       , Hh^Fp       , Gs^Fms      , Gs^Fms      , Gll^Fp      , Gs^Fms      , Gs^Fds      , Gll^Fp      , Gll^Fp      , Gs^Fds      , Gg^Gvs      , Gg^Gvs      , Gg^Gvs      , Rr          , Gg          , Gg          , Gg          , Gg^Gvs      , Gg          , Gg          , Gg^Gvs      , Gg          , Gg          , Gg          , Gg          , Gs          , Gs          , Gs          , Gs          , Hh          , Hh          , Hh          , Hh          , Hh^Dr       , Hhd^Dr      , Hhd^Dr      , Re          , Re          , Hhd^Dr      , Hhd^Dr      , Md          , Md          , Md          , Md          , Md          , Md          
Hh^Fp       , Hh^Fp       , Hh^Fp       , Gs^Fds      , Gs^Fds      , Gs^Fds      , Gs^Fds      , Gs^Fds      , Gg^Gvs      , Gg^Gvs      , Gg^Gvs      , Gg^Gvs      , Gg^Gvs      , Rr          , Ce          , Gg          , Gg          , Gg          , Gg^Gvs      , Gg^Gvs      , Gg^Gvs      , Gg^Gvs      , Gg^Gvs      , Gg          , Gg          , Gg          , Gg          , Gs          , Gs          , Hh          , Wwr         , Rd          , Rd          , Hhd^Dr      , Re          , Re          , Hhd^Dr      , Hhd^Dr      , Hhd         , Md          , Md          , Md          , Md          , Md          , Md          , Md          
Hh^Fp       , Hh^Fp       , Hh^Fp       , Gll^Fp      , Gll^Fp      , Gll^Fp      , Gs^Fds      , Gs^Fds      , Gs^Fds      , Gg^Gvs      , Gg^Gvs      , Gg^Gvs      , Ce          , Rr          , Rp          , Gg^Wm       , Gg^Gvs      , Gg^Gvs      , Gg^Gvs      , Gg^Gvs      , Gg^Gvs      , Gg^Gvs      , Gg          , Gg          , Wwt         , Wwt         , Wwt         , Gs          , Wwt         , Wwr         , Wwt         , Wwr         , Rd          , Rd          , Re          , Hhd         , Hhd         , Hhd         , Md          , Md          , Md          , Md          , Md          , Md          , Md          , Md          
Hh^Fp       , Hh^Fp       , Gll^Fp      , Gll^Fp      , Gs^Fds      , Gs^Fds      , Gs^Fds      , Gs^Fds      , Gs^Fds      , Gs^Fds      , Gg          , Gg          , Rp          , Rp          , Gs^Vl       , Rp          , Rp          , Gg^Gvs      , Gg^Gvs      , Gg^Gvs      , Gg          , Gg          , Wwt         , Wwt         , Ww          , Ww          , Ww          , Wwt         , Ww          , Ww          , Ww          , Wwt         , Wwt^Bsb/    , Re          , Rd          , Hh          , Hh          , Hh          , Hhd         , Md          , Md          , Md          , Md          , Md          , Wwr         , Md          
Gll^Fp      , Hh^Fp       , Gll^Fp      , Gll^Fp      , Gs^Fds      , Gs^Fds      , Gs^Fds      , Gs^Fds      , Gg          , Gg          , Rp          , Rp          , Gg          , Gg          , Gg^Gvs      , Gg^Gvs      , Gg^Gvs      , Rp          , Rp          , Gg          , Rr^Vhc      , Wwt         , Ww          , Ww          , Ch          , Ch          , Ch          , Ww          , Ch          , Ch          , Rrc         , Wot^Bsb/    , Ww          , Wwt         , Wwr         , Rp          , Rp          , Hh          , Hhd         , Hhd         , Hhd         , Md          , Ww          , Wwr         , Md          , Wwr         
Gll^Fp      , Gll^Fp      , Gs^Fds      , Gs^Fds      , Gs^Fds      , Gs^Fds      , Rp          , Gs^Vl       , Rp          , Rp          , Rp          , Gg          , Gg          , Gg^Gvs      , Gg^Gvs      , Gg^Gvs      , Gg^Wm       , Gg^Gvs      , Gg^Gvs      , Rp          , Wwt^Bw\     , Wwt         , Ww          , Ch          , Rrc         , Rrc         , Rrc         , Ch          , Rr          , Rrc         , Rr^Vhc      , Ch          , Ww          , Wwt         , Gs          , Gs          , Rp          , Gg          , Ww          , Hhd         , Wwr         , Wwr         , Md          , Md          , Md          , Md          
Gs^Fds      , Gs^Fds      , Gs^Fds      , Gs^Fds      , Gs^Fds      , Gs^Fds      , Gg          , Rp          , Gg          , Gg          , Gg^Gvs      , Rp          , Rp          , Gs^Vh       , Gg          , Gg^Gvs      , Gg^Gvs      , Gg^Gvs      , Wwt         , Wwt         , Ww          , Wwt^Bw\     , Wot^Bw\     , Ch          , Rrc         , Rr^Vhc      , Rr^Vhc      , Rrc         , Rrc         , Rrc         , Rr          , Ch          , Ww          , Wwt         , Wwt         , Gg          , Ww          , Wwr^Bw\     , Rp          , Wwr         , Hhd         , Hhd         , Hhd         , Md          , Md          , Md          
Gs^Fds      , Gs^Fds      , Gs^Fds      , Gs^Fds      , Gg          , Gg          , Gg          , Gg          , Gg^Gvs      , Gg^Gvs      , Gg^Gvs      , Gg^Gvs      , Gg^Gvs      , Rp          , Rp          , Gg          , Gg          , Wwt         , Ww          , Ww          , Ch          , Ww          , Ch          , Rrc         , Rrc         , Rr^Vhc      , Rr          , Rr^Vhc      , Rr          , Rr^Vhc      , Ch          , Ch          , Ch          , Ww          , Ww          , Ww          , Gg          , Gg          , Rp          , Gg          , Gg          , Hhd         , Gg          , Hhd         , Hhd         , Hhd         
Gs^Fds      , Gs^Fds      , Gs^Fds      , Gs^Fds      , Gg          , Gg          , Gg^Gvs      , Gg^Gvs      , Gg^Gvs      , Gg^Gvs      , Gg^Gvs      , Gg^Gvs      , Gg^Gvs      , Gg^Gvs      , Rp          , Gs^Vh       , Wwr^Bw\     , Wwt         , Ww          , Ch          , Wwt         , Ch          , Rr^Vhc      , Rrc         , Rr^Vhc      , Rrc         , Kh          , Kh          , Kh          , Ch          , Rr          , Rr          , Rr          , Ch          , Ww          , Wwt         , Gg^Efm      , Gg          , Gg          , Rp          , Rp          , Gg          , Gg^Gvs      , Gg          , Gg          , Gg          
Gs^Fds      , Gs^Fds      , Gs^Fds      , Gg          , Gg          , Gg          , Gg          , Gg^Gvs      , Gg^Gvs      , Gg^Gvs      , Gg^Gvs      , Gg^Gvs      , Rp          , Rp          , Gg          , Gg          , Wwr         , Wwt         , Ww          , Ww          , Wwt         , Wwt^Bw\     , Rrc         , Rrc         , Rrc         , Rr^Vhc      , Kh          , 2 Kud       , Kh          , Rrc         , Rrc         , Rr^Vhc      , Rr          , Ch          , Ww          , Wwt         , Gg          , Gg          , Gg^Gvs      , Gg^Gvs      , Rp          , Gg^Gvs      , Gg^Gvs      , Gg^Gvs      , Gg^Gvs      , Gg          
Gs^Fds      , Gs^Fds      , Gs^Fds      , Gg          , Gg^Efm      , Gg          , Gg^Efm      , Gg          , Gg          , Gg^Gvs      , Rp          , Rp          , Gg          , Gg          , Gg^Efm      , Wwr         , Wwt         , Wwt         , Ww          , Ww          , Wwt         , Wwt^Bw/     , Rr^Vhc      , Rr^Vhc      , Rr^Vhc      , Rrc         , Rr^Vhc      , Kh          , Rrc         , Rrc         , Gg^Fet      , Rrc         , Ch          , Ch          , Ww          , Wwt         , Wwt         , Gg^Gvs      , Gg^Gvs      , Gg^Gvs      , Rp          , Gg^Gvs      , Gg^Gvs      , Gg^Gvs      , Gg^Gvs      , Gg^Gvs      
Gs^Fds      , Gs^Fds      , Gg          , Gg          , Gg          , Gg          , Gg          , Gg          , Gg          , Gg          , Rp          , Gg^Wm       , Gg^Efm      , Gg^Efm      , Wwt         , Wwt         , Wwt         , Wwt         , Ww          , Ch          , Ch          , Ch          , Ch          , Rr          , Rrc         , Rrc         , Rrc         , Ch          , Rr          , Rrc         , Rrc         , Rrc         , Rrc         , Ch          , Ch          , Ww          , Wwt         , Gg^Gvs      , Gg^Gvs      , Gg^Gvs      , Rp          , Gs^Vl       , Gg          , Gg^Gvs      , Gg^Gvs      , Gg^Gvs      
Gs^Fds      , Gg          , Gs          , Gg          , Gs          , Gs          , Gg          , Gg^Efm      , Gg          , Gg          , Ch          , Rrc         , Wwt^Bsb\    , Wwt         , Wwt         , Wwt         , Gg          , Ww          , Ww          , Ww          , Ww          , Ww          , Ww          , Ch          , Rr          , Rr^Vhc      , Rr^Vhc      , Ch          , Rr          , Rr^Vhc      , Rr^Vhc      , Ch          , Ch          , Rrc         , Wot^Bsb\    , Ww          , Wwr         , Gg^Gvs      , Rp          , Rp          , Rr^Vhc      , Gg          , Rr          , Rr^Wm       , Gg          , Gg^Gvs      
Gs^Fds      , Gg          , Gg          , Gs          , Gs          , Gs          , Gg          , Gg          , Gg          , Gg          , Wwt         , Wwt         , Wwt         , Wwt^Bsb\    , Rrc         , Gg^Efm      , Gg          , Wwr         , Wwr         , Wwt         , Wwt         , Ww          , Ww          , Ch          , Ch          , Rr          , Ch          , Ch          , Ch          , Rr          , Ch          , Ch          , Ww          , Ch          , Ww          , Wwt^Bsb\    , Rr^Bsb\     , Rr^Vhc      , Rp          , Rr          , Rp          , Rp          , Rr^Vhc      , Gg          , Gs^Vh       , Gg          
Gg          , Gg          , Gg^Efm      , 3 Gs        , Gg          , Gs          , Gg          , Gg          , Gg          , Wwt         , Wwt         , Wwt         , Gg          , Ch          , Gg          , Rrc         , Rp          , Gg          , Gg          , Gd          , Gd          , Wwt         , Wwt         , Ww          , Ww          , Ch          , Ww          , Ww          , Ww          , Ch          , Ww          , Ww          , Wwt         , Ww          , Wwr         , Wwt         , Rrc         , Rrc         , Rrc         , Rr          , Rp          , Rp          , Rp          , Rp          , Rp          , Gg          
Gg          , Gg          , Gg          , Gs          , Gg^Efm      , Gs          , Gg          , Gg          , Wwt         , Wwt         , Wwt         , Wwt         , Gg          , Gg          , Gg          , Gg          , Gg          , Rp          , Rp          , Gs^Vh       , Gg          , Gd          , Gll         , Wwt         , Wwt         , Ww          , Wwt         , Wwt         , Wwt         , Ww          , Wwt         , Wwt         , Gs^Vh       , Wwt^Bw/     , Rrc         , Rrc         , Rp          , Rr^Vhc      , Rp          , Rrc         , Rrc         , Rr^Vhc      , Rp          , Rr^Vhc      , Ch          , Gg          
Gg          , Gg          , Gg          , Gg          , Gs          , Gg          , Gg          , Gg          , Wwt         , Wwt         , Wwt         , Gg          , Gg          , Gg          , Gg          , Gg^Efm      , Gg^Gvs      , Gg^Gvs      , Gg^Gvs      , Rp          , Rp          , Gg^Efm      , Gg          , Gll         , Gll         , Wwt         , Gg          , Gg          , Gg          , Wwt         , Gg          , Gg          , Rrc         , Rrc         , Gg^Gvs      , Rp          , Rr^Vhc      , Rp          , Rr^Vhc      , Rp          , Rr^Vhc      , Rrc         , Rrc         , Ch          , Gs^Vl       , Gg          
Gg          , Gg          , Gg^Efm      , Gs          , Gs          , Gg          , Gg          , Gg          , Wwt         , Wwt         , Wwt         , Gg          , Gg          , Gg          , Gg^Gvs      , Gg^Gvs      , Gg^Gvs      , Gg^Gvs      , Gg^Gvs      , Gg^Gvs      , Gg^Gvs      , Rp          , Rp          , Gg          , Gs^Wm       , Gg          , Gg^Gvs      , Gg^Gvs      , Gg^Gvs      , Gg          , Rr          , Rrc         , Gg^Gvs      , Gg^Gvs      , Gg^Gvs      , Gg^Gvs      , Gg^Gvs      , Rp          , Rp          , Rp          , Ch          , Ch          , Gg^Gvs      , Rrc         , Rrc         , Gg          
Gg          , Gg          , Gs          , Gs          , Gg          , Gg          , Wwt         , Wwt         , Wwt         , Wwt         , Gg          , Gg          , Gg          , Gg^Gvs      , Gg^Gvs      , Gg^Gvs      , Gg^Gvs      , Gg^Gvs      , Gg^Gvs      , Gg^Gvs      , Gg^Gvs      , Gg^Gvs      , Gs^Vh       , Rp          , Rp          , Gg^Gvs      , Gg^Gvs      , Gg^Gvs      , Rr          , Rr          , Gg^Gvs      , Gg          , Gg          , Gg^Gvs      , Gg^Gvs      , Gg^Gvs      , Gg^Gvs      , Gg^Gvs      , Gs^Vl       , Gg^Gvs      , Gg^Gvs      , Gg^Gvs      , Gg^Gvs      , Gg^Gvs      , Gg^Gvs      , Rrc         
Gg          , Gs          , Gs          , Gg          , Gg          , Wwt         , Wwt         , Wwt         , Wwt         , Gg          , Gg          , Gg          , Gg          , Gg          , Gg          , Gg^Gvs      , Gg^Gvs      , Gg^Gvs      , Gg^Gvs      , Gg^Gvs      , Gg          , Gg          , Gg          , Gg^Gvs      , Gg^Gvs      , Rp          , Rr          , Rr          , Gg^Gvs      , Gg^Gvs      , Gg^Gvs      , Gg          , Gg          , Gg          , Gg          , Gg^Gvs      , Gg          , Gg          , Gg          , Gg          , Gg^Efm      , Gg^Gvs      , Gg^Gvs      , Gg^Gvs      , Gg^Gvs      , Gg^Gvs      
Wwt         , Gg          , Gg          , Gg^Efm      , Wwt         , Wwt         , Wwt         , Wwt         , Gg          , Gg          , Gg          , Gg          , Gg^Efm      , Gg          , Gg          , Gg          , Gg          , Gg^Gvs      , Gg          , Gg          , Gs          , Gg          , Gg          , Gg^Gvs      , Gg^Gvs      , Gg^Gvs      , Rr          , Gg^Gvs      , Gg^Gvs      , Gg^Gvs      , Gg^Gvs      , Gg          , Gs^Fds      , Gs^Fds      , Gs^Fds      , Gg          , Gs          , Gg          , Gg^Gvs      , Gg          , Gg^Wm       , Gg          , Gg          , Gg^Gvs      , Gg^Gvs      , Gg^Gvs      
Wwt         , Wwt         , Wwt         , Wwt         , Wwt         , Wwt         , Wwt         , Gg          , Gg          , Gs          , Gg          , Gg          , Gg          , Gg          , Gg          , Gg          , Gg          , Gg          , Gs          , Gs          , Gs          , Gs          , Gg          , Gg^Gvs      , Gg^Gvs      , Gg^Gvs      , Rr          , Gg^Gvs      , Gg^Gvs      , Gg^Gvs      , Gg^Gvs      , Gg          , Gs^Fds      , Gs^Fds      , Gg          , Gs          , Gg^Gvs      , Gg^Gvs      , Gg^Gvs      , Gg^Gvs      , Gg^Gvs      , Gg^Efm      , Gg          , Gg          , Gg          , Gg          
Wwt         , Wwt         , Wwt         , Wwt         , Wwt         , Wwt         , Gg          , Gg          , Gs          , Gs          , Gg          , Gg          , Gs^Fds      , Gg          , Gs^Fds      , Gg          , Gg          , Gs          , Gs          , Gs          , 4 Gg        , Gg          , Gg          , Gg^Gvs      , Gg^Gvs      , Gg^Gvs      , Rr          , Gg^Gvs      , Gg^Gvs      , Gg^Gvs      , Gg^Gvs      , Gg          , Gs^Fds      , Gg          , Gg^Gvs      , Gg^Gvs      , Gg^Gvs      , Gg^Gvs      , Gg^Gvs      , Gg^Gvs      , Gg          , Gg          , Gg          , Gg          , Gs^Fds      , Gg          
Gg          , Gg          , Gg          , Gg          , Gg          , Gg          , Gg          , Gg          , Gs          , Gs          , Gs^Fds      , Gs^Fds      , Gs^Fds      , Gs^Fds      , Gs^Fds      , Gs^Fds      , Gs^Fds      , Gs          , Gg          , Gs          , Gg          , Gg          , Gg          , Gg^Gvs      , Rr          , Rr          , Gs^Vh       , Gg^Gvs      , Gg^Gvs      , Gg^Gvs      , Gg          , Gg          , Gs^Fds      , Gg          , Gg          , Gg^Gvs      , Gg^Gvs      , Gg^Gvs      , Gg          , Gg          , Gg          , Gg^Efm      , Gs^Fds      , Gs^Fds      , Gs^Fds      , Gs^Fds      
Gg          , Gs          , Gs          , Gg          , Gg          , Gg          , Gs^Fds      , Gg          , Gs^Fds      , Gs^Fds      , Gs^Fds      , Gs^Fds      , Gs^Fds      , Gs^Fds      , Gs^Fds      , Gs^Fds      , Gs^Fds      , Gs^Fds      , Gs^Fds      , Gg          , Gg          , Gg          , Rr          , Rr          , Gg          , Gg          , Gg          , Gg^Gvs      , Gg          , Gg          , Gs^Fds      , Gs^Fds      , Gs^Fds      , Gs^Fds      , Gs^Fds      , Gg          , Gg          , Gg^Efm      , Gg          , Gg          , Gs^Fds      , Gs^Fds      , Gs^Fds      , Gs^Fds      , Gs^Fds      , Gs^Fds      
Gg          , Gg          , Gg          , Gg          , Gg          , Gs^Fds      , Gs^Fds      , Gs^Fds      , Gs^Fds      , Gs^Fds      , Gs^Fds      , Gs^Fds      , Gs^Fds      , Gs^Fds      , Gg          , Gs^Fds      , Gg          , Gs^Fds      , Gg          , Gg          , Rr          , Rr          , Gg          , Gg          , Gg          , Gg          , Gg          , Gg          , Gg          , Gs^Fds      , Gg          , Gs^Fds      , Gg          , Gs^Fds      , Gg          , Gg          , Gg          , Gg          , Gg          , Gs^Fds      , Gs^Fds      , Gs^Fds      , Gs^Fds      , Gs^Fds      , Gs^Fds      , Gs^Fds      
