border_size=1
usage=map

Wog         , Wog         , Wwg         , Wwg         , Ch^Es       , Wwg         , Ch          , Ch          , Ch          , Kh          , Ch          , Ch          , Ch          , Kh          , Ch          , Ch          , Ch          , Kh          , Ch          , Ch          , Ch          
Wwg         , Wwg         , Ch          , Ch          , Chr^Es      , Chr         , Khr         , Ch          , Rrc         , Rrc         , Rrc         , Rrc         , Rrc         , Rrc         , Rrc         , Rrc         , Rrc         , Rrc         , Rrc^Es      , Rrc         , Rrc         
Wwg         , Chr         , Chr         , Kh          , Rb^Dr       , Rb^Dr       , Re^Es       , Rrc         , Rrc         , Rrc         , Rrc         , Rrc         , Rrc         , Rrc         , Rrc         , Rrc         , Rrc         , Rrc^Es      , Rrc         , Rrc         , Rrc         
Chr         , Chr         , Chr         , Rp          , Re^Es       , Re^Es       , Re^Dr       , Rrc         , Rrc         , Rrc^Es      , Rrc         , Rrc         , Ce          , Ke          , Rrc         , Ke          , Ce          , Rrc         , Rrc         , Rrc         , Rr^Vhc      
Rb          , Kh          , Rrc         , Rrc         , Rrc^Fdf     , Rr          , Rr^Vl       , Rr^Vhcr     , Rr^Vhr      , Rrc         , Rrc         , Ce          , Rr^Vd       , Rrc         , Rr          , Rrc         , Rrc         , Ce          , Rrc         , Rr^Vhc      , Rr^Vhc      
Rrc         , Rb          , Rb^Es       , Rrc         , Gll^Fmf     , Gs^Fdf      , Re^Vhc      , Rr^Vhc      , Rrc         , Rrc         , Rrc         , Ce          , Rrc         , Rr          , Rr          , Rr          , Rr^Vd       , Ce^Es       , Rrc         , Rrc         , Rrc         
Rrc         , Rb^Dr       , Rrc         , Gd^Es       , Gd^Eff      , Gd^Eff      , Gd^Gvs      , Rrc         , Rrc^Es      , Rrc         , Rrc         , Ce          , Ce          , Rrc         , Rrc         , Rrc         , Ce          , Ce          , Rrc         , Rrc         , Gd          
Rrc         , Rrc         , Rr^Ve       , Rp^Vhcr     , Re^Vhc      , Rb^Dr       , Gd^Gvs      , Rrc         , Rrc         , 2 Rrc       , Rrc         , Rrc         , Rrc         , Ke          , Rrc         , Ke          , Rrc         , Rrc         , Rrc         , Rrc         , Gd^Fdf      
Rrc         , Rrc         , Rrc         , Rr^Vhc      , Rp^Vhcr     , Rr^Vhhr     , Rrc         , Rrc         , Rrc         , Rrc         , Rrc         , Rrc         , 1 Rrc       , Rrc         , Rrc         , Rrc         , Rrc         , Rrc^Es      , Rrc         , Hhd^Fdf     , Gd^Fdf      
Gd^Fdf      , Rrc^Es      , Rrc         , Rrc         , Rrc         , Rrc         , Rrc         , Rrc^Es      , Rr^Vhc      , Rrc^Es      , Rrc         , Rrc         , Rrc         , Rrc         , Rr^Vhc      , Gd          , Gll^Fmf     , Rrc         , Rrc         , Gd          , Gd^Em       
Rrc         , Rrc         , Rr^Vhr      , Rrc         , Rrc         , Rrc^Es      , Rrc         , Rp^Vhcr     , Rr^Vhc      , Rr^Vl       , Rr^Vhc      , Rrc         , Rrc         , Rrc         , Gd          , Gd^Fdf      , Rr^Ve       , Rr^Vhc      , Rrc         , Rrc         , Rrc         
Rrc         , Rr^Vhc      , Rr^Vhc      , Rr^Vhc      , Rrc         , Rrc         , Rrc         , Gd          , Rr^Vhc      , Gd^Fdf      , Rrc         , Rrc         , Rrc         , Rrc         , Rrc         , Rr^Vhc      , Rrc         , Rrc         , Rrc         , Rrc         , Rrc         
Rrc         , Rrc         , Rrc         , Rrc         , Rrc         , Rrc         , Rrc         , Rr^Vhc      , Gd          , Gll^Fmf     , Rrc         , Rrc         , Rrc         , Rrc         , Rrc         , Rrc         , Rrc         , Rrc         , Rrc         , Rrc         , Rrc         
