border_size=1
usage=map

Gs          , Gs          , Gs          , Gs          , Gs          , Gs          , Rp          , Gs          , Gs          , Gs          , Gd^Fdf      , Hhd^Fdf     , Hhd^Fdf     , Hhd^Fdf     , Hhd^Fdf     , Hhd^Fdf     , Hhd^Fdf     , Hhd^Fdf     , Hhd^Fdf     , Hhd^Fdf     , Hhd^Fdf     , Hhd^Fdf     , Hhd         , Hhd         , Md          , Md          , Mm          , Mm          , Md^Xm       , Md^Xm       , Md^Xm       , Mm          , Mm          , Ms          , Ms          , Ms          , Ms          , Ms          , Ha          , Aa^Fpa      , Aa^Fpa      , Aa^Fpa      , Aa^Fma      , Aa^Fpa      , Aa^Fma      , Ha^Fpa      
Gs          , Gg^Fet      , Gs          , Gs          , Gs          , Gs          , Rp          , Gs          , Gd          , Gs          , Gd^Fdf      , Gd^Fdf      , Gd^Fdf      , Hhd^Fdf     , Gd^Fdf      , Hhd^Fdf     , Hhd^Fdf     , Hhd^Fdf     , Hhd         , Hhd^Fdf     , Hhd         , Hhd         , Hhd         , Hhd         , Md          , Md          , Md^Xm       , Md^Xm       , Mm          , Mm          , Ms          , Ms          , Ms          , Ms          , Ms          , Ms          , Ms          , Ms          , Ha          , Aa^Fpa      , Aa^Fpa      , Aa^Fpa      , Aa^Fpa      , Aa^Fpa      , Ha^Fpa      , Ha^Fpa      
Gs          , Gs          , Gs          , Gd          , Ce          , Gd          , Rp          , Gs^Vh       , Gd          , Gd^Fdf      , Gd          , Hhd^Fdf     , Hhd         , Hhd^Fdf     , Hhd^Fdf     , Hhd         , Hhd         , Hhd         , Md          , Md          , Md          , Md          , Md          , Md          , Md^Xm       , Md^Xm       , Mm          , Mm          , Mm          , Ms          , Ms          , Ms          , Ms^Xm       , Ms          , Ms          , Ms          , Ha          , Ha          , Ha          , Aa^Fpa      , Aa^Fpa      , Aa^Fma      , Aa^Fpa      , Ha^Fpa      , Ha^Fma      , Ha^Fpa      
Gs          , Gs          , Gs          , Ce          , 1 Ke        , Ce          , Gd          , Rp          , Rp          , Gd          , Gd          , Hh          , Hhd         , Hhd         , Md          , Md          , Md          , Md          , Mm          , Mm          , Md^Xm       , Md^Xm       , Md          , Md          , Mm          , Mm          , Ms          , Mm          , Ms          , Ms          , Ms^Xm       , Ms^Xm       , Ms          , Ms          , Ha          , Ha          , Ha          , Ha          , Aa^Fpa      , Aa^Fma      , Aa^Fpa      , Aa^Fpa      , Aa^Fpa      , Ha^Fpa      , Ha^Fpa      , Ha^Fpa      
Gs          , Gs          , Gs          , Ce          , Ce          , Ce          , Gd          , Gd          , Gd          , Rp          , Rp          , Hh          , Ce          , Md          , Md          , Md          , Md          , Md          , Md^Xm       , Md^Xm       , Md^Xm       , Md^Xm       , Md          , Mm          , Mm          , Mm          , Ms          , Ms^Xm       , Ms^Xm       , Ms^Xm       , Ms^Xm       , Ms^Xm       , Ms          , Ha          , Ha          , Ha          , Ha^Fpa      , Aa^Fpa      , Aa^Fpa      , Aa^Fma      , Aa^Fma      , Aa^Fpa      , Aa^Fpa      , Ha^Fma      , Ha^Fpa      , Ha^Fpa      
Gd^Fdf      , Gs          , Gd          , Gd          , Gd          , Gd          , Gd          , Gd          , Hhd         , Hh          , Hhd         , Rp          , Re          , Gd^Vo       , Md          , Md          , Md          , Md          , Md          , Md          , Mm          , Md          , Md          , Mm          , Ms          , Ms          , Ms          , Ms^Xm       , Ms^Xm       , Ms^Xm       , Ms          , Ms          , Ha          , Ha          , Ha^Fpa      , Ha^Fpa      , Aa^Fpa      , Aa^Fpa      , Aa^Fma      , Ha^Fma      , Aa^Fpa      , Aa^Fma      , Aa^Fpa      , Ha^Fma      , Ha^Fpa      , Ha^Fpa      
Gd^Fdf      , Gd^Fdf      , Gd          , Gd          , Hh          , Gs^Vh       , Hhd         , Hhd         , Hhd         , Hhd         , Hhd         , Ce          , Gd^Vo       , Re          , Hhd         , Md          , Hhd         , Md          , Mm          , Mm          , Mm          , Md          , Ms          , Ms          , Ms          , Ms          , Ms^Xm       , Ms^Xm       , Ms          , Ms          , Ha          , Ha          , Ha          , Ha^Fpa      , Ha^Fpa      , Ha^Fpa      , Ha^Fda      , Aa^Fpa      , Aa^Fpa      , Aa^Fpa      , Aa^Fma      , Aa^Fma      , Aa^Fpa      , Ha^Fma      , Ha^Fpa      , Ha^Fpa      
Gd^Fdf      , Gd^Fdf      , Gd          , Gd          , Hh          , Hhd         , Hhd         , Hhd         , Hh^Vhh      , Md          , Mm          , Mm          , Mm          , Hhd         , Hhd         , Hhd         , Hhd         , Ha          , Ha          , Mm          , Ms          , Md          , Ms          , Ms          , Ms          , Ms          , Ms          , Ms          , Ms          , Ha          , Ha          , Ha          , Ha^Fpa      , Ha^Fpa      , Ha^Fpa      , Ha^Fma      , Aa^Fma      , Aa^Fpa      , Aa^Fpa      , Aa^Fpa      , Aa^Fpa      , Aa^Fma      , Aa^Fpa      , Ha^Fpa      , Ha^Fpa      , Ha^Fpa      
Gd^Fdf      , Gd^Fdf      , Hhd^Fdf     , Hh          , Hhd         , Md          , Md          , Md          , Md          , Mm          , Mm          , Mm          , Ms          , Mm          , Ms          , Ha          , Ha          , Hhd         , Hhd         , Ha^Fda      , Ms          , Ms          , Ms          , Ms          , Ms          , Ms          , Ms          , Ms          , Ha          , Ha          , Ha          , Ha          , Ha^Fpa      , Ha^Fpa      , Aa^Fpa      , Aa^Fpa      , Aa^Fma      , Aa^Fpa      , Aa^Fma      , Aa^Fma      , Aa^Fpa      , Aa^Fpa      , Aa^Fpa      , Ha^Fpa      , Ai          , Ha^Fpa      
Gd^Fdf      , Hhd^Fdf     , Hhd         , Hhd         , Md          , Md          , Md^Xm       , Md          , Mm          , Mm          , Mm          , Mm          , Ms          , Ms          , Ms          , Ms          , Ms          , Ha          , Hhd         , Ha          , Aa^Voa      , Ms          , Ms          , Ms          , Ms          , Ms          , Ms          , Ha          , Ha          , Ha          , Ha^Fpa      , Ha^Fpa      , Aa^Fpa      , Aa^Fpa      , Ha^Fma      , Aa^Fpa      , Aa^Fpa      , Aa^Fpa      , Aa^Fpa      , Aa^Fma      , Aa^Fpa      , Aa^Fpa      , Ai          , Ai          , Ha^Fpa      , Ai          
Hhd^Fdf     , Hhd^Fdf     , Hhd         , Md          , Md          , Md^Xm       , Md^Xm       , Md^Xm       , Mm          , Mm          , Ms          , Ms          , Ms^Xm       , Ms          , Ms          , Ms          , Ms          , Ha          , Ha          , Ha          , Ha          , Ha^Fma      , Ms          , Ms          , Ms          , Ms          , Ha          , Ha          , Ha^Fpa      , Ha^Fpa      , Ha^Fpa      , Ha^Fpa      , Aa^Fpa      , Ha^Fda      , Aa^Fpa      , Aa^Fpa      , Aa^Fpa      , Aa^Fpa      , Aa^Fpa      , Aa^Fpa      , Aa^Fpa      , Ai          , Aa^Fpa      , Ha^Fpa      , Ha^Fpa      , Ha^Fpa      
Hhd^Fdf     , Hhd         , Md          , Md          , Mm          , Md^Xm       , Mm          , Mm          , Mm          , Mm          , Ms          , Ms          , Ms^Xm       , Ms^Xm       , Ms          , Ms          , Ms          , Ha^Fda      , Ms          , Ha          , Ha          , Ha^Fma      , Ha^Fma      , Ms          , Ms          , Ms          , Ha^Fpa      , Ha^Fpa      , Ha^Fpa      , Ha^Fpa      , Ha^Fma      , Aa^Fpa      , Ha^Fma      , Ha^Fma      , Aa^Voa      , Aa^Fpa      , Aa^Fpa      , Aa^Fpa      , Aa^Fpa      , Aa^Fpa      , Ai          , Ai          , Aa^Fpa      , Ha^Fpa      , Ha^Fma      , Ha^Fpa      
Hhd         , Hhd         , Md          , Md          , Md^Xm       , Md^Xm       , Mm          , Mm          , Ms          , Ms          , Ms          , Ms          , Ms          , Ms^Xm       , Ms          , Ms          , Ms          , Ms          , Ms          , Ha^Fma      , Ha          , Ha          , Ha^Fma      , Ms          , Ms          , Ms          , Ha^Fpa      , Ha^Fpa      , Ha^Fda      , Ha^Fpa      , Ha^Fma      , Aa^Fpa      , Aa^Fpa      , Aa^Fpa      , Aa^Fpa      , Aa^Fpa      , Ai          , Ai          , Ai          , Ai          , Aa^Fpa      , Aa^Fpa      , Ha^Fpa      , Ha^Fpa      , Ha^Fma      , Ha^Fpa      
Md          , Md          , Md^Xm       , Md^Xm       , Mm          , Mm          , Mm          , Ms          , Ms          , Ms          , Ms^Xm       , Ms          , Ms          , Ms          , Ms          , Ms          , Ms          , Ms          , Ms          , Ha^Fma      , Aa^Fpa      , Aa          , Aa^Fpa      , Ha^Fma      , Ha^Fpa      , Ha^Fpa      , Ha^Fpa      , Ha^Fpa      , Aa^Fpa      , Aa^Fpa      , Aa^Fpa      , Aa^Fpa      , Aa^Fpa      , Aa^Fpa      , Aa^Fpa      , Aa^Fpa      , Ai          , Aa^Fpa      , Aa^Fpa      , Aa^Fpa      , Aa^Fma      , Aa^Fpa      , Ha^Fpa      , Ha^Fpa      , Ha^Fpa      , Ha^Fma      
Md          , Mm          , Md^Xm       , Md^Xm       , Mm          , Mm          , Ms          , Ms          , Ms^Xm       , Ms^Xm       , Ms^Xm       , Ms^Xm       , Ms          , Ms          , Ms          , Ms          , Ms          , Ms          , Ha^Fma      , Ha^Fma      , Aa^Fpa      , Aa          , Aa          , Aa^Fpa      , Ha^Fpa      , Ha^Fpa      , Ha^Fda      , Ha^Fma      , Aa^Fpa      , Aa^Fpa      , Aa^Fpa      , Aa^Fpa      , Ai          , Ai          , Ai          , Ai          , Aa^Fpa      , Aa^Fpa      , Aa^Fma      , Aa^Fpa      , Aa^Fpa      , Aa^Fpa      , Ha^Fpa      , Ha^Fma      , Ha^Fpa      , Ha^Fpa      
Md^Xm       , Md^Xm       , Mm          , Mm          , Ms          , Ms          , Ms          , Ms          , Ms          , Ms^Xm       , Ms^Xm       , Ms^Xm       , Ms          , Ms          , Ms          , Ms          , Ha^Fma      , Ha^Fma      , Ha^Fma      , Ha^Fma      , Aa^Fpa      , Aa^Voa      , Aa          , Aa^Fpa      , Aa^Fpa      , Aa^Fpa      , Aa^Fpa      , Aa^Fpa      , Ha^Fma      , Aa^Fpa      , Aa^Fpa      , Ai          , Aa^Fpa      , Aa^Fpa      , Aa^Fpa      , Aa^Fpa      , Aa^Fma      , Aa^Fma      , Aa^Fma      , Aa^Fma      , Ha^Fda      , Ha^Fpa      , Ha^Fda      , Ha^Fma      , Ms          , Ha^Fpa      
Md^Xm       , Md^Xm       , Mm          , Mm          , Ms          , Ms          , Ms^Xm       , Ms          , Ms          , Ms          , Ms          , Ms          , Ms          , Ms          , Ha          , Ha          , Ha^Fma      , Ha^Fma      , Ha^Fma      , Aa^Fpa      , Aa^Fpa      , Aa^Fpa      , Aa          , Aa^Fpa      , Aa^Fpa      , Aa^Fpa      , Aa^Fpa      , Aa^Voa      , Aa^Fpa      , Aa^Fpa      , Ai          , Ai          , Aa^Fpa      , Aa^Fpa      , Aa^Fma      , Aa^Fpa      , Aa^Fma      , Aa^Fpa      , Aa^Fma      , Aa^Fpa      , Ha^Fma      , Ha^Fma      , Ms          , Ha^Fpa      , Ha^Fda      , Ha^Fpa      
Mm          , Mm          , Mm          , Ms          , Ms          , Ms          , Ms^Xm       , Ms^Xm       , Ms          , Ms          , Ms          , Ms          , Ha          , Ha^Fda      , Ha^Fma      , Ha^Fma      , Ha^Fma      , Ha^Fma      , Ha^Fma      , Aa^Fpa      , Aa^Fpa      , Aa^Fpa      , Aa          , Aa^Fpa      , Aa^Fpa      , Aa^Fpa      , Aa^Fpa      , Aa^Fpa      , Aa^Fpa      , Aa^Fpa      , Ai          , Aa^Fpa      , Aa^Fma      , Aa^Fma      , Aa^Fma      , Aa^Fma      , Aa^Fpa      , Aa^Fpa      , Ha^Fda      , Ha^Fpa      , Ha^Fpa      , Ha^Fpa      , Ha^Fpa      , Ha^Fma      , Ha^Fma      , Ha^Fpa      
Mm          , Mm          , Ms          , Ms          , Ms          , Ms^Xm       , Ms^Xm       , Ms          , Ms          , Ms          , Ha          , Ha          , Ha^Fma      , Ha^Fda      , Ha^Fma      , Ha^Fma      , Ha^Fpa      , Ha^Fma      , Ha^Fma      , Aa^Fpa      , Aa^Fpa      , Aa^Fpa      , Aa^Fpa      , Aa          , Aa          , Aa^Fpa      , Aa^Fpa      , Aa^Fpa      , Aa^Fpa      , Aa^Fpa      , Ai          , Aa^Fma      , Aa^Fma      , Aa^Fma      , Aa^Fma      , Aa^Fpa      , Aa^Fma      , Aa^Fpa      , Ha^Fpa      , Ha^Fpa      , Ms          , Ha^Fpa      , Ha^Fma      , Ms          , Ha^Fpa      , Ha^Fpa      
Ms          , Ms          , Ms          , Ms          , Ms^Xm       , Ms^Xm       , Ms          , Ms          , Ha^Fda      , Ha          , Ha^Fda      , Ha^Fma      , Ha^Fma      , Ha^Fma      , Ha^Fpa      , Aa^Voa      , Ha^Fma      , Ha^Fpa      , Ha^Fpa      , Ha^Fma      , Ha^Fda      , Aa^Fpa      , Aa^Fpa      , Aa^Fpa      , Aa^Fpa      , Aa          , Ai^Bw\      , Ai          , Ai          , Ai          , Aa^Fma      , Aa^Fma      , Aa^Fpa      , Aa^Fpa      , Aa^Fma      , Aa^Fpa      , Ha^Fma      , Ha^Fma      , Ha^Fpa      , Ha^Fma      , Ha^Fda      , Ha^Fma      , Ha^Fpa      , Ha^Fma      , Ha^Fda      , Ha^Fpa      
Ms          , Ms          , Ms          , Ms^Xm       , Ms^Xm       , Ms          , Ha          , Ha          , Ha^Fma      , Ha^Fda      , Ha^Fma      , Ha^Fda      , Ha^Fma      , Ha^Fma      , Ha^Fma      , Ha^Fpa      , 3 Ha^Kov    , Ha^Cov      , Ha^Fpa      , Aa^Voa      , Aa^Fpa      , Aa^Fpa      , Aa^Fpa      , Aa^Fpa      , Aa^Fma      , Aa^Fpa      , Ai          , Aa          , Rrc         , Aa^Fma      , Aa^Fma      , Aa^Fma      , Aa^Fpa      , Aa^Fpa      , Ha^Fpa      , Ha^Fpa      , Ha^Fpa      , Ha^Fma      , Ms          , Ha^Fpa      , Ha^Fma      , Ha^Fpa      , Ms          , Ha^Fpa      , Ms          , Ms          
Ms          , Ms          , Ms^Xm       , Ms^Xm       , Ms          , Ms          , Ha^Fda      , Ha^Fma      , Ha^Fda      , Ha^Fda      , Ha^Fma      , Ha^Fma      , Ha^Fma      , Ha^Fpa      , Ha^Fma      , Ha^Fma      , Ha^Fma      , Ha^Fma      , Ha^Fma      , Ha^Fma      , Aa^Fpa      , Aa^Fpa      , Aa^Fpa      , Aa^Fma      , Aa^Fma      , Aa^Fma      , Ai          , Cea         , Aa^Voa      , Rrc         , Rrc         , Aa^Fma      , Ha^Fpa      , Ha^Fpa      , Ha^Fma      , Ha^Fma      , Ha^Fpa      , Ha^Fpa      , Ms          , Ms          , Ha^Fma      , Ha^Fma      , Ms          , Ms          , Ms          , Ms          
Ms^Xm       , Ms^Xm       , Ms          , Ms          , Ha          , Ha          , Ha^Fpa      , Ha^Fma      , Ha^Fpa      , Ha^Fpa      , Ha^Fda      , Ha^Fma      , Ha^Fpa      , Ha^Fma      , Ha^Fma      , Ha^Fpa      , Ha^Fma      , Ha^Fpa      , Aa^Fpa      , Aa^Fpa      , Aa^Fpa      , Aa^Fpa      , Aa^Fpa      , Aa^Fpa      , Aa^Fpa      , Ai          , Aa^Fma      , Aa^Fma      , Aa^Fma      , Aa^Fma      , Aa^Fma      , Rrc         , Rrc         , Ha^Fpa      , Aa          , Aa          , Cha         , Cha         , Ha          , Ha          , Ha^Fma      , Ms          , Ms          , Ms          , Ms^Xm       , Ms^Xm       
Ms^Xm       , Ms          , Ha          , Ha          , Ha^Fpa      , Ha^Fpa      , Ha^Fpa      , Ha^Fma      , Ha^Fma      , Ha^Fma      , Ha^Fpa      , Ha^Fma      , Ha^Fma      , Aa^Voa      , Ha^Fpa      , Ha^Fpa      , Ha^Fma      , Aa^Fpa      , Aa^Fpa      , Aa^Fpa      , Aa^Fma      , Aa^Fma      , Aa^Fma      , Aa^Fpa      , Ai          , Ai          , Aa^Fpa      , Aa^Fma      , Aa^Fma      , Aa^Fma      , Ha^Fma      , Ha^Fpa      , Aa          , Rrc         , Rr          , Cha         , Ha          , Ha          , Ha^Vhha     , Ha^Fma      , Ha^Fma      , Ms^Xm       , Ms^Xm       , Ms^Xm       , Ms^Xm       , Ms^Xm       
Ms^Xm       , Ms          , Ha^Fda      , Ha^Fpa      , Ha^Fpa      , Ha^Fda      , Aa^Fpa      , Ha^Fma      , Ha^Fma      , Ha^Fma      , Ha^Fda      , Ha^Fpa      , Ha^Fma      , Ha^Fma      , Ha^Fma      , Ha^Fma      , Aa^Fpa      , Aa^Fpa      , Aa^Fpa      , Aa^Voa      , Aa^Fpa      , Aa^Fpa      , Aa^Fma      , Aa^Fpa      , Ai          , Ai          , Aa^Fpa      , Aa^Fma      , Aa^Fma      , Aa^Fma      , Ha^Fma      , Ha^Fma      , Aa          , Cha         , Ha          , Rrc         , Rrc         , Rrc         , Rrc         , Ha          , Ha          , Ha^Fma      , Ms^Xm       , Ms^Xm       , Ms^Xm       , Ms^Xm       
Ms          , Ha^Fpa      , Ha^Fda      , Ha^Fpa      , Ha^Fpa      , Ha^Fda      , Ha^Fpa      , Ha^Fma      , Ha^Fma      , Ha^Fpa      , Ha^Fma      , Ha^Fma      , Ha^Fma      , Ha^Fma      , Ha^Fpa      , Ha^Fma      , Aa^Fpa      , Aa^Fpa      , Aa^Fpa      , Aa^Fma      , Aa^Fpa      , Aa^Fma      , Aa^Fpa      , Aa^Fpa      , Ai          , Aa^Fma      , Aa^Fma      , Aa^Fpa      , Ha^Fpa      , Ha^Fma      , Aa          , Aa          , Cha         , Cha         , Ha          , Ha          , Ha^Fma      , Ha          , Ha          , Rrc         , Rrc         , Ms          , Ms^Xm       , Ms^Xm       , Ms          , Ms          
Aa^Fpa      , Ha^Fda      , Ha^Fda      , Ha^Fpa      , Ha^Fpa      , Ha^Fpa      , Aa^Fpa      , Ha^Fpa      , Ha^Fpa      , Ha^Fma      , Ha^Fpa      , Ha^Fda      , Ha^Fpa      , Ha^Fpa      , Aa^Fpa      , Aa^Fpa      , Aa^Fpa      , Aa^Fpa      , Aa^Fma      , Aa^Fma      , Aa^Fma      , Aa^Fpa      , Ai          , Ai          , Aa^Fma      , Aa^Fma      , Aa^Fpa      , Aa^Fpa      , Ha^Fpa      , Ha^Fpa      , Aa          , Cha         , Ha          , Ha          , Ms          , Ms          , Ms          , Ms          , Rrc^Vhca    , Ha^Fma      , Rrc         , Ha          , Ha^Fma      , Ms^Xm       , Ms^Xm       , Ms          
Ha^Fpa      , Ha^Fpa      , Aa^Fpa      , Aa^Fpa      , Aa^Fpa      , Aa^Fpa      , Aa^Fpa      , Aa^Fpa      , Aa^Fpa      , Ha^Fma      , Ha^Fma      , Ha^Fma      , Aa^Fpa      , Aa^Fpa      , Aa^Fma      , Aa^Fma      , Aa^Fma      , Aa^Fma      , Aa^Fpa      , Aa^Fma      , Aa^Fma      , Ai          , Aa^Fma      , Aa^Fma      , Aa^Fma      , Aa^Fpa      , Aa^Fma      , Ha^Fma      , Ha^Fma      , Ha^Fma      , Ha^Fma      , Ha^Fpa      , Ms          , Ha          , Rrc         , Ha^Vhha     , Rrc         , Rrc         , Rrc         , Aa^Fma      , Ha^Fda      , Rrc         , Ha^Vhha     , Ms^Xm       , Ms^Xm       , Ms^Xm       
Ha^Fpa      , Ha^Fpa      , Aa^Fpa      , Aa^Fpa      , Aa^Fpa      , Aa^Fpa      , Aa^Fpa      , Aa^Fpa      , Aa^Fpa      , Ha^Fma      , Ha^Fma      , Ha^Fma      , Aa^Fpa      , Aa^Fpa      , Aa^Fma      , Aa^Fma      , Aa^Fpa      , Aa^Fpa      , Aa^Fma      , Aa^Fma      , Ai          , Ai          , Aa^Fpa      , Aa^Fma      , Aa^Fpa      , Aa^Fma      , Ha^Fma      , Ha^Fma      , Ha^Fda      , Ha^Fda      , Ha          , Ha^Fpa      , Ha^Fma      , Aa^Vha      , Rrc         , Rrc         , Cha         , Cha         , Cha         , Rrc         , Ha^Fpa      , Rrc         , Ha          , Ms          , Ms          , Ms^Xm       
Aa^Fpa      , Aa^Fpa      , Aa^Fpa      , Ha^Fda      , Aa^Fpa      , Aa^Fpa      , Aa^Fpa      , Aa^Fpa      , Aa^Fpa      , Aa^Fpa      , Aa^Fpa      , Aa^Fpa      , Aa^Fpa      , Aa^Fma      , Aa^Fpa      , Aa^Fpa      , Ai          , Ai          , Ai          , Ai          , Aa^Fpa      , Aa^Fpa      , Aa^Fma      , Aa^Fma      , Ha^Fma      , Ha^Fma      , Ha^Fpa      , Ha^Fma      , Ha^Fma      , Ha          , Ms          , Ms          , Ha^Fma      , Rrc         , Rrc         , Cha         , Cha         , 2 Kha       , Rr          , Rrc         , Rrc         , Rrc         , Aa^Vha      , Ms          , Ms^Xm       , Ms^Xm       
Aa^Fpa      , Aa^Fpa      , Aa^Fpa      , Aa^Fpa      , Aa^Fpa      , Aa^Fpa      , Aa          , Aa^Fpa      , Aa          , Aa^Fpa      , Ai          , Ai          , Ai          , Aa^Fpa      , Ai          , Ai          , Aa^Fma      , Aa^Fpa      , Aa^Fpa      , Aa^Fpa      , Ha^Fma      , Aa^Fpa      , Aa^Fma      , Ha^Fma      , Ha^Fma      , Ha^Fma      , Ha^Fda      , Ha^Fda      , Ha          , Ha          , Ms          , Ms          , Ms          , Ha^Fma      , Aa^Vha      , Rrc         , Rrc         , Rr          , Rrc         , Rrc^Vhca    , Rrc^Vhca    , Ha^Fpa      , Ms          , Ms          , Ms^Xm       , Ms^Xm       
Aa^Fpa      , Aa^Fpa      , Aa^Fpa      , Aa^Fpa      , Aa          , Aa          , Ai          , Aa          , Ai          , Ai          , Aa          , Aa^Fpa      , Aa^Fpa      , Ai          , Aa^Fma      , Aa^Fma      , Aa^Fma      , Aa^Fpa      , Ha^Fda      , Ha^Fma      , Aa^Fma      , Ha^Fma      , Aa^Fpa      , Ha^Fma      , Ha^Fma      , Ha^Fpa      , Ha^Fpa      , Ha^Fda      , Ha          , Ms          , Ms          , Ms          , Ms          , Ms          , Ha          , Rr          , Ha^Vhha     , Rrc^Vhca    , Ha^Vhha     , Rrc         , Rrc         , Ha^Fma      , Ms          , Ms^Xm       , Md^Xm       , Md^Xm       
Aa          , Aa          , Aa          , Aa          , Ai          , Ai          , Aa          , Ai          , Aa          , Aa          , Ha^Fpa      , Ha^Fda      , Ha^Fma      , Ha^Fma      , Ha^Fma      , Ha^Fma      , Ha^Fma      , Ha^Fda      , Ha^Fda      , Ha^Fma      , Ha^Fma      , Ha^Fma      , Ha^Fma      , Ha^Fma      , Ha^Fma      , Ha^Fma      , Ha^Fda      , Ha          , Ms          , Ms          , Ms          , Ms          , Ms          , Ms          , Ms          , Ms          , Ms^Xm       , Ms          , Ms          , Ha^Fpa      , Ha^Fma      , Rrc         , Aa^Vla      , Ms^Xm       , Mm^Xm       , Ms^Xm       
Ai          , Ai          , Ai          , Ai          , Aa          , Aa          , Ha^Fda      , Ha^Fda      , Ms^Xm       , Ha^Fda      , Ms^Xm       , Ms^Xm       , Ms^Xm       , Ms^Xm       , Ms^Xm       , Ms^Xm       , Ms^Xm       , Ha^Fda      , Ms^Xm       , Ms^Xm       , Ms          , Ms          , Ms          , Ms          , Ms          , Ha^Fda      , Ms          , Ms          , Ms          , Ms          , Ms^Xm       , Ms          , Ms          , Ms          , Ms^Xm       , Ms^Xm       , Ms^Xm       , Ms^Xm       , Ms^Xm       , Ms          , Ms^Xm       , Ms^Xm       , Mm^Xm       , Mm^Xm       , Mm^Xm       , Ms^Xm       
Aa          , Aa          , Aa          , Aa          , Ms^Xm       , Ms^Xm       , Ms          , Ms          , Ms          , Ms          , Ms          , Ms          , Ms^Xm       , Ms          , Ms          , Ms^Xm       , Ms          , Ms          , Ms          , Ms          , Ms          , Ms          , Ms          , Ms          , Ms          , Ms          , Ms          , Ms          , Aa          , Ms^Xm       , Aa          , Ms          , Ms          , Ms^Xm       , Ms^Xm       , Ms^Xm       , Ms^Xm       , Ms^Xm       , Ms^Xm       , Ms^Xm       , Ms^Xm       , Ms^Xm       , Ms^Xm       , Ms^Xm       , Ms^Xm       , Ms^Xm       
