border_size=1
usage=map

Hhd         , Md^Xm       , Md^Xm       , Md          , Md          , Wwr         , Wwr         , Hhd         , Md          , Md^Xm       , Md          , Hhd         , Hhd         , Gll         , Gd          , Gll         , Ss          , Gll         , Sm          , Ss          , Ss          , Ss          , Ss          , Sm          , Sm          , Rb          , Rb          , Gd          , Gd^Em       , Ss          , Rb          , Ss          , Sm          , Ss          , Sm          , Sm          , Ss          , Ss          , Wwf         , Sm          , Sm          , Sm          , Ss          , Sm          , Rb          , Rb          
Mm          , Hhd         , Mm          , Md^Xm       , Md          , Md          , Md          , Wwr         , Ww          , Md          , Gll         , Gll         , Gll         , Gll         , Gd^Em       , Ss          , Rb          , Rb          , Ss^Vm       , Sm          , Sm          , Sm          , Sm          , Ss          , Sm          , Ss          , Ss          , Re          , Re          , Re          , Ss          , Ss          , Ss          , Sm          , Ss          , Ss          , Sm          , Ss          , Wo          , Ss          , Sm          , Ss          , Ss          , Sm          , Ss          , Rb          
Mm          , Hhd         , Hhd         , Hhd         , Hhd         , Md          , Md          , Hhd         , Ww          , Gll         , Gs          , Gs^Vc       , Wwf         , Gll         , Rb          , Rb          , Ss          , Ss          , Ss          , Ss          , Ss          , Sm          , Sm          , Ss          , Ss          , Sm          , Ss          , Ss          , Wwg         , Ss          , Sm          , Ss          , Ss          , Sm          , Sm          , Ss          , Ss          , Sm          , Wo          , Ss          , Ss          , Sm          , Ss          , Ss          , Sm          , Sm          
Md^Xm       , Mm          , Hhd         , Hhd         , Hhd         , Md          , Md          , Hhd         , Gll         , Wwg         , Wwg         , Wwg         , Gd          , Wwg         , Sm          , Sm          , Sm          , Wo          , Wo          , Ss          , Ss          , Ss          , Ss          , Ss          , Sm          , Sm          , Ss          , Ss          , Wwf         , Wwg         , Ss          , Ss          , Sm          , Sm          , Sm          , Sm          , Ss          , Ss          , Sm          , Sm          , Sm          , Sm          , Ss          , Sm          , Ss          , Sm          
Md^Xm       , Mm          , Hhd         , Gll^Em      , Gll         , Hhd         , Hhd         , Hhd         , Gll         , Gll         , Gll         , Gll         , Gs          , Ss          , Sm          , Ss          , Ss          , Ss          , Ss          , Wwg         , Sm          , Sm          , Ss          , Sm          , Sm          , Ss          , Sm          , Rb          , Ss          , Sm          , Ss          , Sm          , Ss          , Ss          , Sm          , Ss          , Sm          , Wwg         , Sm          , Ss          , Ss          , Sm          , Ss          , Sm          , Wwg         , Sm          
Mm          , Mm          , Hhd         , Gll         , Gll         , Re^Vct      , Hhd         , Hhd         , Hhd         , Gll         , Gll         , Gd          , Ss          , Sm          , Sm          , Sm          , Sm          , Sm          , Sm          , Ww          , Ss          , Ss          , Sm          , Sm          , Ss          , Sm          , Ss          , Ss          , Wwf         , Ss          , Sm          , Sm          , Sm          , Ss          , Ss          , Sm          , Ss          , Sm          , Ss          , Sm          , Sm          , Sm          , Wwg         , Wo          , Sm          , Sm          
Mm          , Hhd         , Hhd         , Gll         , Gll         , Gll         , Hhd         , Mm          , Hhd         , Gd          , Gll^Em      , Gd          , Rb          , Sm          , Gll         , Ss          , Sm          , Ss          , Sm          , Wo          , Wwg         , Ss          , Ss          , Ss          , Sm          , Sm          , Sm          , Rb          , Wwf         , Rb          , Ss          , Ss          , Ss          , Sm          , Sm          , Ss          , Sm          , Sm          , Ss          , Re          , Gd          , Gd          , Wwg         , Ss          , Ss          , Sm          
Hhd         , Hhd         , Gll         , Gll         , Gs          , Gd          , Gd          , Hhd         , Gd          , Gd          , Re^Vct      , Gll         , Gll         , Rb          , Sm          , Ss          , Sm          , Ss^Vm       , Sm          , Ss          , Ss          , Ss^Vm       , Ss          , Sm          , Ss^Vm       , Ss          , Sm          , Ss          , Sm          , Ss          , Ss          , Sm          , Sm          , Sm          , Ss          , Ss          , Sm          , Sm          , Sm          , Sm          , Sm          , Re          , Sm          , Wwg         , Sm          , Ss          
Mm          , Hhd         , Re^Vct      , Gll         , Gs          , Gll         , Gll         , Gd          , Gd          , Gd          , Gll         , Gd          , Gll         , Sm          , Sm          , Ss          , Sm          , Wo          , Ss          , Sm          , Wwg         , Wwf         , Sm          , Sm          , Ss          , Sm          , Ss          , Ss          , Ss          , Wwg         , Ss          , Ss          , Rb          , Ss          , Rb          , Sm          , Sm          , Ss          , Ss          , Ss          , Sm          , Ss          , Sm          , Sm          , Ss          , Sm          
Md^Xm       , Hhd         , Hhd         , Gll         , Gll         , Gll         , Gs          , Gll         , Gll         , Gll         , Gd          , Gll         , Rb          , Rb          , Ss          , Sm          , Ss^Vhs      , Sm          , Sm          , Sm          , Gll         , Sm          , Sm          , Ss          , Sm          , Ss          , Sm          , Ss          , Ss          , Sm          , Sm          , Ss          , Ss          , Wwf         , Ss          , Ss          , Sm          , Sm          , Ss          , Wwf         , Sm          , Ss          , Sm          , Wo          , Wwg         , Sm          
Md^Xm       , Hhd         , Hhd         , Gll         , Gd          , Gll         , Gll         , Rb          , Gll         , Rb          , Sm          , Ss          , Sm          , Sm          , Ss          , Sm          , Sm          , Ss          , Wo          , Wwg         , Ss          , Hhd         , Sm          , Ss          , Sm          , Sm          , Ss^Vm       , Ss          , Ss          , Ss          , Rb          , Rb          , Gs          , Gd          , Rb          , Rb          , Ss          , Gd          , Rb          , Sm          , Ss^Vhs      , Sm          , Sm          , Wwg         , Ss          , Sm          
Md^Xm       , Mm          , Hhd         , Gd          , Gd          , Gll         , Gll         , Gll         , Rb^Bw\      , Ss          , Sm          , Ss          , Ss          , Rb          , Sm          , Ss          , Sm          , Ss          , Ss          , Sm          , Ss          , Chs         , 3 Khs       , Ss          , Sm          , Sm          , Ss          , Sm          , Wwg         , Wwf         , Rb          , Gd          , Gd          , Gd^Vht      , Gs          , Re          , Gs          , Gs          , Ss          , Ss          , Rb          , Sm          , Sm          , Ss          , Ss          , Ss          
Mm          , Mm          , Hhd         , Hhd         , Gd          , Gd          , Gll         , Gd          , Rb          , Sm^Bw\      , Sm^Bw\      , Ss          , Sm          , Ss^Vhs      , Ss          , Sm          , Ss          , Gd          , Sm          , Ss^Vm       , Wwg         , Chs         , Chs         , Chs         , Ss          , Ss          , Ss          , Sm          , Ss          , Sm          , Wwg         , Wwf         , Sm          , Ss          , Re          , Gd          , Gd          , Gd^Vl       , Gd          , Gd          , Gd          , Ss          , Sm          , Wwg         , Sm          , Ss          
Hhd         , Hhd         , Gd          , Gll         , Gll         , Gd          , Gll         , Gd^Em       , Ss          , Sm          , Ss          , Sm^Bw\      , Sm^Bw\      , Ss          , Sm          , Ss          , Sm          , Ss          , Ss          , Ss          , Rb          , Sm          , Wwg         , Wwf         , Ss          , Sm          , Sm          , Ss          , Sm          , Ss          , Sm          , Ss          , Rb          , Rb          , Gd          , Gd          , Ss          , Gs          , Re          , Re          , Ss          , Rb          , Ss          , Ss          , Sm          , Sm          
Gll         , Gll         , Gs          , Gs^Vc       , Gd          , Gd          , Gll         , Rb          , Ss          , Sm          , Sm          , Sm          , Ss          , Sm^Bw\      , Sm^Bw\      , Sm          , Ss          , Sm          , Ss          , Ss          , Sm          , Sm          , Wwg         , Wwf         , Wwg         , Sm          , Ss          , Ss^Vhs      , Sm          , Sm          , Ss          , Sm          , Ss          , Rb          , Ss          , Rb          , Sm          , Rb          , Sm          , Rb          , Ss          , Ss          , Ss          , Sm          , Ss          , Sm          
Gll         , Gll         , Gll         , Gll         , Gll         , Gll         , Ss          , Sm          , Sm          , Sm          , Ss          , Ss          , Sm          , Ss          , Sm          , Sm^Bw\      , Sm^Bw\      , Rb          , Hhd         , Rb          , Gll         , Ss          , Ss          , Ss          , Ss          , Wwg         , Wo          , Ss          , Sm          , Ss          , Sm          , Sm          , Ss          , Ss          , Sm          , Sm          , Gd          , Ss          , Ss          , Sm          , Sm          , Ss^Vm       , Sm          , Sm          , Gd          , Ss          
Rb          , Gd          , Ss          , Rb          , Ss          , Gll         , Ss          , Ss          , Ss          , Ss^Vm       , Sm          , Sm          , Sm          , Ss          , Ss^Vm       , Sm          , Ss          , Rb^Bw\      , Gll         , Hhd         , Ss          , Sm          , Sm          , Sm          , Sm          , Sm          , Sm          , Sm          , Ss          , Sm          , Sm          , Ss          , Ss          , Ss          , Sm          , Ss          , Rb          , Sm          , Ss          , Ss          , Sm          , Sm          , Sm          , Re          , Gll^Es      , Sm          
Sm          , Rb          , Sm          , Sm          , Ss^Vm       , Rb          , Sm          , Ss          , Ss          , Ss          , Sm          , Ss          , Ss          , Sm          , Sm          , Sm          , Rb          , Gd          , Ss          , Rb^Bw\      , Ss^Bw\      , Sm          , Sm          , Ss          , Sm          , Ss          , Wwg         , Ss          , Sm          , Ss          , Sm          , Ss          , Sm          , Sm          , Sm          , Ss^Vhs      , Sm          , Sm          , Sm          , Sm          , Ss          , Sm          , Gd          , Gd          , Gll         , Gd          
Sm          , Ss          , Sm          , Sm          , Sm          , Sm          , Sm          , Ss          , Chs         , Chs         , Chs         , Sm          , Rb          , Ss          , Sm          , Gll         , Gd          , Gs          , Ss          , Ss          , Rb          , Wwg^Bw\     , Rb^Bw\      , Ss          , Ss          , Ss          , Wwg         , Sm          , Sm          , Ss          , Ss          , Sm          , Sm          , Sm          , Ss          , Sm          , Rb          , Rb          , Gll         , Ss          , Gll         , Ss          , Gll         , Ss          , Gll         , Gll         
Ss          , Ss          , Sm          , Rb          , Ss          , Ss          , Rb          , Rb          , Wwf         , 2 Khs       , Chs         , Ss          , Re          , Rb          , Ss          , Ss          , Rb          , Gs^Vht      , Ss          , Ss          , Ss          , Ss          , Sm          , Rb^Bw\      , Ss^Bw\      , Wwf         , Ss          , Ss          , Ss          , Sm          , Sm          , Sm          , Gs^Vht      , Ss          , Gd          , Rb          , Gll         , Gll         , Ss          , Ss          , Gll         , Gd          , Gs^Vht      , Gll         , Ss          , Gll         
Wwg         , Rb          , Re          , Sm          , Ss          , Ss^Vm       , Sm          , Ss          , Wwf         , Ss          , Wwf         , Rb          , Ss          , Ss^Vm       , Sm          , Sm          , Sm          , Ss          , Sm          , Ss          , Sm          , Sm          , Rb          , Sm          , Ss          , Sm^Bw\      , Sm^Bw\      , Sm          , Ss          , Sm          , Ss          , Rb          , Gll         , Gd          , Gll         , Gll         , Gs^Vc       , Gs^Fdw      , Gll         , Gll         , Gs^Fdw      , Gll         , Gll         , Gll         , Gll^Fmf     , Gll^Fmf     
Gll         , Gd          , Gd          , Gd          , Sm          , Sm          , Ss          , Ss          , Ss          , Wwf         , Ss          , Wwg         , Wwf         , Ss          , Sm          , Rb          , Sm          , Ss          , Wwf         , Ss          , Ss          , Sm          , Ss          , Sm          , Ss          , Ss          , Ss          , Sm^Bw\      , Sm^Bw\      , Ss          , Rb          , Gd          , Ss          , Ss          , Ss          , Gd^Fmw      , Gll         , Gd          , Gs^Fdw      , Gll         , Gll         , Gll         , Gll         , Ss          , Gll^Fmf     , Gll^Fmf     
Gll         , Gs          , Ss          , Re          , Ss          , Sm          , Ss^Vm       , Sm          , Ss          , Ss          , Sm          , Ss          , Sm          , Wwg         , Sm          , Gll         , Sm          , Ss          , Sm          , Wwg         , Sm          , Wwg         , Sm          , Wwg         , Ss          , Sm          , Sm          , Ss^Vhs      , Ss          , Rb^Bw\      , Gll         , Gll         , Gd          , Gs          , Gs^Fdw      , Gll         , Gd^Fmw      , Gll         , Gll         , Gll         , Gd^Fmw      , Gll         , Re^Vct      , Gll^Fmf     , Gd^Fdf      , Gd^Fdf      
Gll         , Re          , Sm          , Ss          , Sm          , Sm          , Sm          , Sm          , Ss          , Sm          , Sm          , Sm          , Sm          , Ss          , Sm          , Sm          , Ss^Vhs      , Ss          , Sm          , Gd          , Ss          , Sm          , Gll         , Ss          , Ss          , Sm          , Sm          , Ss          , Rb          , Gd          , Gll         , Gll         , Gll         , Gd          , Gll         , Gll         , Gll         , Gll         , Gll         , Gd          , Gll         , Gll         , Gd          , Gll         , Gll         , Gd^Fdf      
Ss          , Rb          , Ss          , Sm          , Ss          , Ss          , Ss          , Rb          , Gd          , Ss          , Rb          , Ss          , Sm          , Sm          , Wwg         , Ss          , Ss          , Ss          , Sm          , Ss          , Sm          , Wwg         , Ss          , Ss          , Sm          , Sm          , Sm          , Ss          , Rb          , Gll         , Gll         , Gs^Vc       , Gs^Fdw      , Gll         , Gll         , Gll         , Gll         , Gll         , Gd          , Gll         , Gll         , Gs^Fdw      , Gll         , Gll         , Gd          , Gll         
Ss          , Ss          , Rb          , Gd          , Ss          , Ss          , Ss          , Sm          , Sm          , Gll^Em      , Sm          , Sm          , Ss          , Ss          , Sm          , Wwg         , Ss          , Sm          , Sm          , Ss          , Ss          , Sm          , Sm          , Sm          , Sm          , Ss          , Ss          , Rb          , Gll         , Gll         , Gd          , Gll         , Gd^Fmw      , Gs^Fdw      , Gd          , Gd          , Gll         , Gs^Fdw      , Gll         , Gd          , Ce          , Ce          , Ce          , Gd          , Ce          , Gll         
Ss          , Ss          , Sm          , Rb          , Rb          , Ss          , Sm          , Ss          , Ss          , Sm          , Sm          , Ss^Vhs      , Ss          , Ss          , Sm          , Ss          , Wwf         , Ss          , Sm          , Sm          , Wog         , Ss          , Wog         , Ss          , Sm          , Rb          , Gll         , Gll         , Gs^Vht      , Gll         , Gd          , Gll         , Gll         , Gll         , Gd          , Gd          , Gll         , Gll         , Gll         , Gg          , Gd^Fmw      , Gs^Fdw      , Gll         , Ce          , Gll         , Ce          
Ss          , Ss          , Sm          , Ss          , Sm          , Sm          , Ss          , Ss          , Sm          , Ss          , Sm          , Sm          , Wwg         , Sm          , Sm          , Ss          , Ss          , Sm          , Sm          , Ss^Vhs      , Ss          , Ss          , Ss          , Wwg         , Wwg         , Ss          , Gd          , Gll         , Ss          , Gd          , Gll         , Gs^Fdw      , Gll         , Gd          , Gs^Fdw      , Gll         , Ce          , Ce          , Gd          , Gd          , Gs          , Gs^Vh       , Gs          , Gs^Fdw      , Re^Vct      , Gll         
Sm          , Sm          , Ss          , Ss          , Sm          , Ss          , Re          , Ss          , Ss          , Sm          , Sm          , Ss          , Wwf         , Wwg         , Ss          , Sm          , Ss^Vhs      , Ss          , Sm          , Sm          , Ss          , Ss          , Sm          , Sm          , Rb          , Wwf         , Wwf         , Gs^Fdw      , Gd^Fmw      , Gll         , Gd          , Gll         , Re^Vct      , Gll         , Gll         , Gs^Fdw      , Ce          , Gd          , Re^Vct      , Gs          , Gs          , Gs          , Ce          , Gd          , Gs          , Gll         
Ss          , Ss^Vhs      , Gd          , Ss          , Sm          , Rb          , Sm          , Ss          , Sm          , Sm          , Ss          , Ss          , Ss          , Sm          , Sm          , Sm          , Ss          , Sm          , Wwg         , Wwg         , Ss          , Sm          , Sm          , Sm          , Gll         , Gll         , Gs^Vc       , Wwf         , Wwf         , Gs^Fdw      , Gll         , Gd          , Ww          , Gll         , Ww          , Gll         , Ce          , Gll         , Gll         , Gs          , Gs          , Ce          , 1 Ke        , Ce          , Gs          , Gll         
Ss          , Ss          , Ss          , Ss          , Wwg         , Sm          , Wwg         , Ss          , Sm          , Ss^Vhs      , Ss          , Sm          , Sm          , Sm          , Rb          , Ss          , Rb          , Ss          , Ss          , Ss          , Sm          , Ss          , Ss          , Sm          , Rb          , Ss          , Gll         , Gd          , Gs^Fdw      , Wwf         , Wwf         , Wwr         , Ww          , Ww          , Gd^Fmw      , Ww          , Ww          , Ww          , Ww          , Gs^Vh       , Gs          , Ce          , Ce          , Ce          , Gg^Efm         , Gs          
Ss          , Wwg         , Wwg         , Wwg         , Ss          , Ss          , Sm          , Wwg         , Sm          , Sm          , Ss          , Ss          , Sm          , Ss          , Rb          , Gd          , Gs          , Gs          , Gs          , Ss          , Sm          , Sm          , Sm          , Ss          , Sm          , Ss          , Ss          , Gll         , Gll         , Gll         , Gll         , Gll         , Gll         , Gll         , Gll         , Gll         , Gll         , Ce          , Ce          , Ww          , Ww          , Gs          , Gll         , Gs          , Gll         , Gs          
