border_size=1
usage=map

Md^Xm       , Mm          , Md^Xm       , Md^Xm       , Md^Xm       , Md^Xm       , Md^Xm       , Md^Xm       , Md^Xm       , Md^Xm       , Md^Xm       , Md^Xm       , Md^Xm       , Ms          , Ms          , Ms          , Ms          , Md^Xm       , Md^Xm       , Md^Xm       , Md^Xm       , Md^Xm       , Md^Xm       , Md^Xm       , Mm          , Md^Xm       , Mm          , Re          , Hhd         , Md^Xm       , Md^Xm       , Md^Xm       , Md^Xm       , Md^Xm       , Md^Xm       , Md^Xm       , Md^Xm       , Md^Xm       , Md^Xm       , Md^Xm       , Md^Xm       , Md^Xm       , Md^Xm       , Md^Xm       , Md^Xm       , Md^Xm       , Mm          , Mm          , Mm          , Mm          , Mm          , Mm          
Hhd         , Md^Xm       , Md^Xm       , Md^Xm       , Md^Xm       , Md^Xm       , Md^Xm       , Md^Xm       , Md^Xm       , Md^Xm       , Md^Xm       , Md^Xm       , Md^Xm       , Ms          , Ms          , Ms          , Ms          , Ms          , Md^Xm       , Md^Xm       , Md^Xm       , Md^Xm       , Ms^Xm       , Mm          , Mm          , Mm          , Re          , Re          , Mm          , Md^Xm       , Md^Xm       , Md^Xm       , Md^Xm       , Md^Xm       , Md^Xm       , Md^Xm       , Md^Xm       , Md^Xm       , Md^Xm       , Md^Xm       , Md^Xm       , Md^Xm       , Md^Xm       , Md^Xm       , Md^Xm       , Md^Xm       , Mm          , Mm          , Mm          , Mm          , Mm          , Mm          
Rb          , Hhd         , Uh          , Uh          , Uh          , Uh          , Uh          , Uh          , Uh          , Uh          , Uh          , Md^Xm       , Md^Xm       , Md^Xm       , Md^Xm       , Ms          , Md^Xm       , Md^Xm       , Md^Xm       , Md^Xm       , Md^Xm       , Md^Xm       , Mm          , Mm          , Re          , Re          , Mm          , Mm          , Md^Xm       , Ms^Xm       , Md^Xm       , Md^Xm       , Mm          , Md^Xm       , Md^Xm       , Ms^Xm       , Md^Xm       , Md^Xm       , Md^Xm       , Mm          , Mm          , Md^Xm       , Md^Xm       , Md^Xm       , Md^Xm       , Md^Xm       , Md^Xm       , Mm          , Mm          , Mm          , Mm          , Mm          
Rb          , Rb          , Re          , Rb          , Rb          , Rb          , Rb          , Rb          , Rb          , Uu          , Uu          , Uh          , Uh          , Md^Xm       , Md^Xm       , Md^Xm       , Md^Xm       , Md^Xm       , Hhd         , Hh^Vhh      , Hhd         , Md^Xm       , Mm          , Hhd         , Re          , Hhd         , Md^Xm       , Md^Xm       , Md^Xm       , Md^Xm       , Md^Xm       , Md^Xm       , Mm          , Md^Xm       , Md^Xm       , Md^Xm       , Md^Xm       , Md^Xm       , Md^Xm       , Mm          , Mm          , Mm          , Mm          , Md^Xm       , Ms^Xm       , Md^Xm       , Md^Xm       , Md^Xm       , Md^Xm       , Mm          , Md^Xm       , Md^Xm       
Uu          , Rb          , Rb          , Rb          , Rb          , Re          , Rb          , Rb          , Rb          , Re          , Re          , Uu          , Uu          , Md^Xm       , Md^Xm       , Md^Xm       , Uh^Dr       , Hhd         , Gd          , Gd          , Gd          , Hhd         , Re          , Re          , Hhd         , Hhd         , Md^Xm       , Md^Xm       , Md^Xm       , Ms^Xm       , Md^Xm       , Md^Xm       , Mm          , Mm          , Mm          , Md^Xm       , Md^Xm       , Md^Xm       , Ms^Xm       , Mm          , Mm          , Mm          , Mm          , Mm          , Md^Xm       , Md^Xm       , Md^Xm       , Md^Xm       , Md^Xm       , Md^Xm       , Md^Xm       , Md^Xm       
Hhd         , Uu          , Uh          , Uh          , Uh          , Uh          , Uh          , Uh          , Uh          , Rb          , Rb          , Rb          , Rb          , Md          , Hhd         , Md          , Re          , Re          , Re          , Gd          , Re          , Re          , Gs^Vc       , Hhd         , Md^Xm       , Md^Xm       , Md^Xm       , Md^Xm       , Md^Xm       , Md^Xm       , Md^Xm       , Md^Xm       , Md^Xm       , Mm          , Mm          , Md^Xm       , Md^Xm       , Md^Xm       , Md^Xm       , Md^Xm       , Mm          , Mm          , Md^Xm       , Md^Xm       , Md^Xm       , Md^Xm       , Md^Xm       , Md^Xm       , Uh          , Md^Xm       , Uh          , Md^Xm       
Md          , Hhd         , Md          , Md          , Md          , Md          , Md^Xm       , Md          , Md          , Uh          , Uu          , Rb          , Rb          , Rb          , Rb^Bsb/     , Re^Bsb/     , Md          , Uu          , Uu          , Re          , Uu          , Uu          , Hhd         , Hhd         , Md^Xm       , Md^Xm       , Md^Xm       , Md^Xm       , Md^Xm       , Md^Xm       , Md^Xm       , Md^Xm       , Md^Xm       , Mm          , Md^Xm       , Ms^Xm       , Md^Xm       , Md^Xm       , Md^Xm       , Mm          , Md^Xm       , Md^Xm       , Md^Xm       , Md^Xm       , Md^Xm       , Md^Xm       , Uh          , Uh          , Uu^Vu       , Uh          , Uh          , Md^Xm       
Md          , Md          , Md          , Md          , Md          , Md          , Md          , Md          , Md          , Md          , Hhd         , Uu^Es       , Rb^Bsb/     , Rb^Bsb/     , Rb          , Md          , Md          , Uu^Es       , Uu^Es       , Re          , Uu          , Uu          , Hhd         , Md^Xm       , Md^Xm       , Md^Xm       , Md^Xm       , Md^Xm       , Md^Xm       , Md^Xm       , Uh^Dr       , Md^Xm       , Md^Xm       , Md^Xm       , Md^Xm       , Md^Xm       , Md^Xm       , Md^Xm       , Md^Xm       , Md^Xm       , Md^Xm       , Md^Xm       , Md^Xm       , Md^Xm       , Md^Xm       , Md^Xm       , Uh          , Uu^Dr       , Uu          , Uu          , Uu          , Uu          
Md          , Md          , Md          , Md          , Uh          , Uh          , Uu^Vud      , Md          , Uu^Es       , Md          , Re          , Uu^Bsb/     , Uu^Es       , Rb          , Rb          , Uu^Dr       , Md          , Md          , Uu^Vud      , Re          , Uu^Es       , Hhd         , Md          , Md^Xm       , Md^Xm       , Md^Xm       , Uh          , Uh          , Uh          , Uh          , Rb          , Uh          , Uh          , Md^Xm       , Md^Xm       , Md^Xm       , Md^Xm       , Md^Xm       , Md          , Md^Xm       , Md          , Md^Xm       , Md          , Md^Xm       , Md          , Md^Xm       , Ko          , Uu          , Uu          , Uu          , Rb          , Rb          
Md          , Md          , Md          , Md          , Uh          , Uu^Dr       , Uu          , Uu          , Re          , Re          , Md          , Mm^Xm       , Uu          , Rb          , Re          , Uh          , Md          , Md          , Md^Xm       , Re          , Re          , Uh          , Md          , Md^Xm       , Uh          , Uh          , Rb          , Rb          , Re          , Rb          , Rb          , Rb          , Rb          , Uh          , Mm^Xm       , Md^Xm       , Uh          , Uh          , Uh          , Uh          , Uh          , Uh          , Uh          , Md          , Uh          , Co          , Co          , Uu          , Rb          , Rb          , Rb          , Rb          
Md          , Md          , Hh^Vhh      , Hhd         , Uu          , Uu          , Re          , Re          , Uu          , Uu^Es       , Mm^Xm       , Mm^Xm       , Uh          , Rb          , Rb          , Uu          , Uh          , Md          , Md          , Md          , Md          , Re          , Uu^Bw\      , Md          , Rb          , Rb          , Rb          , Rb          , Rb          , Rb          , Uh          , Rb          , Rb          , Rb          , Md          , Md          , Re          , Uu          , Uu          , Uu^Vud      , Uu          , Uu          , Uu          , Uh          , Uu          , Uu          , Uu          , Rb          , Rb          , Rb          , Uu          , Uu          
Md          , Md          , Hh          , Uu          , Uu          , Uu          , Re          , Uu          , Uu          , Md          , Mm^Xm       , Md          , Uh          , Rb          , Rb          , Rb          , Uu          , Uh          , Uh^Dr       , Uh          , Uu          , Md          , Rb          , Rb^Bw\      , Rb^Bw\      , Rb          , Uu          , Uu          , Md^Xm       , Uh          , Md          , Uu          , Rb          , Rb          , Uh^Bw/      , Re          , Uu^Es       , Re          , Re          , Re          , Re          , Uu          , Re          , Rb          , Rb          , Rb          , Rb          , Rb          , Uh          , Co          , Ko          , Uu          
Hh          , Hh          , Hh          , Uu          , Rb          , Rb          , Re          , Rb          , Rb          , Md          , Mm^Xm       , Mm^Xm       , Mm^Xm       , Uh          , Rb          , Rb          , Rb          , Rb          , Rb          , Rb          , Rb          , Rb          , Rb          , Rb          , Uu          , Uu^Bw\      , Uu^Bw\      , Md          , Md          , Md^Xm       , Md          , Rb^Es       , Rb^Bw/      , Rb^Bw/      , Rb          , Md          , Md          , Uu          , Uh          , Uu          , Uh          , Re          , Uh          , Uu^Vud      , Uh          , Uu          , Uh          , Uh          , Md          , Co          , Md          , Uh          
Hh          , Hh          , Gs          , Rb          , Rb          , Re          , Re          , Rb          , Rb          , Hh^Vhh      , Hhd         , Mm^Xm       , Mm^Xm       , Uh          , Uh          , Rb          , Re          , Rb          , Rb          , Re          , Rb          , Rb          , Uu          , Uu          , Md          , Md          , Uu^Es       , Re          , Re          , Uh          , Re          , Uu^Bw/      , Uu^Es       , Rb          , Rb          , Uh          , Md          , Md          , Md          , Uh          , Md          , Uh          , Md^Xm       , Uh          , Md^Xm       , Md          , Md^Xm       , Md^Xm       , Md^Xm       , Md          , Md^Xm       , Md          
Hh          , Hh          , Gs          , Rb          , Ce          , Re          , Ce          , Re          , Rb          , Rb          , Hhd         , Mm^Xm       , Mm^Xm       , Mm^Xm       , Mm^Xm       , Uh          , Uh          , Uh          , Uh          , Uh          , Uh          , Uh          , Mm^Xm       , Mm^Xm       , Md          , Hhd         , Uu          , Uu          , Uu          , Re          , Hhd         , Mm^Xm       , Uu          , Rb          , Re          , Uh          , Md          , Md^Xm       , Md^Xm       , Md^Xm       , Md^Xm       , Md^Xm       , Md          , Md^Xm       , Md^Xm       , Md^Xm       , Md          , Md          , Uh          , Md^Xm       , Md          , Md^Xm       
Gs          , Gs          , Gd          , Gd          , Ce          , 1 Ke        , Ce          , Re          , Re          , Rb          , Hhd         , Mm^Xm       , Mm^Xm       , Mm^Xm       , Mm^Xm       , Mm^Xm       , Mm^Xm       , Mm^Xm       , Mm^Xm       , Mm^Xm       , Mm^Xm       , Mm^Xm       , Mm^Xm       , Mm          , Uh          , Uh          , Uu          , Uu          , Uu          , Uu          , Md          , Mm^Xm       , Uh          , Rb          , Rb          , Uh          , Uh          , Uh          , Uh          , Md^Xm       , Uh          , Uh          , Uh          , Uh          , Uh          , Uh          , Uh          , Uh          , Uu^Dr       , Uh          , Uh          , Md          
Gs          , Gs^Vh       , Gd          , Gd          , Gd          , Ce          , Gd          , Gd          , Gd          , Hhd         , Mm^Xm       , Mm^Xm       , Mm^Xm       , Mm^Xm       , Mm^Xm       , Mm^Xm       , Mm^Xm       , Mm^Xm       , Mm^Xm       , Mm^Xm       , Mm^Xm       , Mm^Xm       , Xu          , Uh          , Uu          , Uu^Vu       , Uu          , Uu          , Uu          , Uh          , Mm^Xm       , Mm^Xm       , Uh          , Rb          , Rb          , Rb          , Rb          , Rb          , Rb          , Uh          , Rb          , Uu          , Rb          , Uu          , Uu          , Uu          , Rb          , Rb          , Rb          , Uu^Dr       , Uu          , Co          
Gs          , Gs          , Gs          , Gs          , Gd          , Gd          , Gd          , Gd          , Re^Vct      , Hhd         , Mm^Xm       , Mm^Xm       , Ms^Xm       , Ms^Xm       , Ms^Xm       , Md^Xm       , Mm^Xm       , Mm^Xm       , Xu          , Mm^Xm       , Xu          , Xu          , Xu          , Xu          , Xu          , Uu          , Uu          , Uu          , Uu^Vu       , Uh          , Mm^Xm       , Mm^Xm       , Mm          , Uu          , Uu          , Rb          , Rb          , Rb          , Re          , Rb          , Rb          , Rb          , Rb          , Rb          , Re          , Rb          , Rb          , Rb          , Rb          , Rb          , Rb          , Co          
Gs          , Gs          , Gs          , Gs^Vh       , Hhd         , Gd          , Hhd         , Gd          , Hhd         , Hhd         , Mm^Xm       , Mm^Xm       , Mm          , Mm          , Mm          , Mm^Xm       , Xu          , Xu          , Xu          , Xu          , Xu          , Xu          , Uu          , Co          , Uu^Ii       , Uu^Ii       , Uu^Ii       , Uh          , Uh          , Uh          , Mm^Xm       , Mm^Xm       , Mm^Xm       , Uh          , Uh          , Uu          , Uh          , Uu          , Uu          , Rb          , Uu          , Rb          , Uu          , Rb          , Rb          , Rb          , Uu          , Uu          , Uu          , Rb          , Re          , Rb          
Gs          , Gs^Vl       , Hh          , Hhd         , Mm^Xm       , Hhd         , Mm^Xm       , Hhd         , Mm^Xm       , Mm^Xm       , Mm^Xm       , Mm^Xm       , Mm^Xm       , Mm          , Md^Xm       , Mm^Xm       , Xu          , Xu          , Ur          , Uu^Emf      , Uu          , Uu          , Uu          , Uu          , Uu          , Uu^Ii       , Co          , Xu          , Mm^Xm       , Mm^Xm       , Mm^Xm       , Mm^Xm       , Mm^Xm       , Mm^Xm       , Mm^Xm       , Uh          , Mm^Xm       , Uh          , Uh          , Uu          , Uh          , Uh          , Uh          , Uh          , Uh          , Uh          , Uh          , Uh          , Uh          , Uu          , Uu          , Rb          
Hh          , Hh          , Mm^Xm       , Mm^Xm       , Mm^Xm       , Mm^Xm       , Mm^Xm       , Mm^Xm       , Mm^Xm       , Mm^Xm       , Mm^Xm       , Mm^Xm       , Mm^Xm       , Mm^Xm       , Mm^Xm       , Mm^Xm       , Xu          , Xu          , Uu^Emf      , Uu^Vu       , Uu          , Uu          , Co          , Uu          , Uu          , Uu          , Xu          , Xu          , Mm^Xm       , Mm^Xm       , Mm^Xm       , Mm^Xm       , Md          , Mm^Xm       , Mm^Xm       , Mm^Xm       , Mm^Xm       , Mm^Xm       , Mm^Xm       , Uh          , Mm^Xm       , Mm^Xm       , Mm^Xm       , Mm^Xm       , Mm^Xm       , Mm^Xm       , Mm^Xm       , Mm^Dr       , Uh          , Uu          , Uu          , Co          
Hh          , Hh          , Mm^Xm       , Mm^Xm       , Ms          , Mm^Xm       , Mm^Xm       , Mm^Xm       , Mm^Xm       , Mm^Xm       , Ms^Xm       , Ms^Xm       , Ms^Xm       , Mm^Xm       , Mm^Xm       , Mm^Xm       , Xu          , Xu          , Uu^Uf       , Uu          , Uu          , Uu          , 2 Ko        , Co          , Uu          , Uu          , Xu          , Xu          , Mm^Xm       , Mm^Xm       , Mm^Xm       , Md          , Md          , Md          , Mm^Xm       , Mm^Xm       , Mm^Xm       , Mm^Xm       , Mm^Xm       , Mm^Xm       , Mm^Xm       , Mm^Xm       , Mm^Xm       , Mm^Xm       , Mm^Xm       , Mm^Xm       , Mm^Xm       , Mm^Xm       , Mm^Xm       , Uh          , Uh          , Co          
Mm^Xm       , Mm^Xm       , Mm^Xm       , Ms          , Ms          , Ms          , Ms          , Md^Xm       , Mm^Xm       , Ms^Xm       , Mm          , Mm          , Mm          , Ms^Xm       , Ms^Xm       , Mm^Xm       , Xu          , Xu          , Xu          , Uu^Uf       , Uu^Emf      , Uu          , Uu          , Uu          , Uu          , Uu          , Xu          , Xu          , Mm^Xm       , Mm^Xm       , Mm^Xm       , Md^Xm       , Mm^Xm       , Md          , Mm^Xm       , Mm^Xm       , Mm^Xm       , Md          , Md          , Md          , Md^Xm       , Mm^Xm       , Mm^Xm       , Md^Xm       , Mm^Xm       , Mm^Xm       , Mm          , Mm^Xm       , Mm^Xm       , Mm^Xm       , Mm^Xm       , Mm^Xm       
Mm^Xm       , Mm^Xm       , Mm^Xm       , Ms          , Ms          , Ms          , Ms          , Mm^Xm       , Mm^Xm       , Mm^Xm       , Mm^Xm       , Mm          , Mm          , Mm          , Mm          , Mm^Xm       , Mm^Xm       , Xu          , Xu          , Xu          , Xu          , Uu          , Uu          , Uu^Vu       , Uu          , Xu          , Xu          , Xu          , Mm^Xm       , Mm^Xm       , Mm^Xm       , Mm^Xm       , Mm^Xm       , Md^Xm       , Mm^Xm       , Mm^Xm       , Mm^Xm       , Md          , Mm^Xm       , Mm^Xm       , Mm^Xm       , Mm^Xm       , Mm^Xm       , Mm^Xm       , Mm          , Mm          , Mm^Xm       , Mm^Xm       , Mm^Xm       , Mm^Xm       , Mm^Xm       , Mm^Xm       
Hhd         , Mm^Xm       , Mm^Xm       , Ms          , Ms          , Ms          , Mm^Xm       , Mm^Xm       , Mm^Xm       , Mm^Xm       , Mm^Xm       , Mm^Xm       , Mm^Xm       , Mm          , Mm^Xm       , Mm^Xm       , Mm^Xm       , Mm^Xm       , Mm^Xm       , Xu          , Xu          , Uu          , Uu          , Uu          , Uu          , Xu          , Xu          , Mm^Xm       , Mm^Xm       , Mm^Xm       , Mm^Xm       , Mm^Xm       , Mm^Xm       , Mm^Xm       , Mm^Xm       , Mm^Xm       , Mm^Xm       , Mm^Xm       , Mm^Xm       , Mm^Xm       , Mm^Xm       , Mm^Xm       , Mm^Xm       , Mm          , Mm^Xm       , Mm^Xm       , Mm^Xm       , Mm^Xm       , Mm^Xm       , Mm^Xm       , Mm^Xm       , Mm^Xm       
