border_size=1
usage=map

Uu          , Uh          , Uh          , Uh          , Uh          , Uh          , Uh          , Uh          , Uh          , Md          , Md          , Md^Xm       , Md          , Md          , Md          , Md          , Md          , Uh          , Uh          , Ql          , Ql          , Uh          , Md          , Md          , Mm          , Md^Xm       , Md^Xm       , Md^Xm       , Md          , Md          , Uue         , Uue         , Uh          , Md^Xm       , Md^Xm       , Md^Xm       , Md^Xm       , Md^Xm       , Qlf^Es      , Qlf^Es      , Uh          , Md^Xm       , Md^Xm       , Md^Xm       , Md^Xm       , Md^Xm       
Uu          , Rp^Vhcr     , Uu          , Uh          , Uh          , Rp^Vhcr     , Rb          , Uh          , Rp^Vhcr     , Md          , Md          , Md          , Md          , Md          , Md          , Md          , Md          , Md          , Md          , Uh          , Ql          , Uh          , Uh^Dr       , Md          , Md          , Md^Xm       , Md          , Md          , Md          , Uue         , Uh          , Uh          , Uh          , Uh          , Uh          , Md^Xm       , Uh^Dr       , Qlf         , Md          , Mv          , Md          , Uh^Dr       , Md^Xm       , Md^Xm       , Md^Xm       , Md^Xm       
Uu          , Uu          , Chr         , Uu          , Uu          , Uh          , Rb          , Rb          , Uh          , Uh          , Uh          , Md          , Md          , Md          , Md          , Md          , Md          , Md          , Md          , Uh^Vu       , Uh^Dr       , Ql          , Ql          , Uh^Dr       , Uh^Dr       , Md          , Md          , Md          , Uue         , Uue         , Uh          , Uh          , Qlf         , Qlf         , Qlf         , Qlf^Es      , Qlf         , Qlf         , Qlf         , Md          , Uh^Es       , Uh^Es       , Md^Xm       , Md^Xm       , Md^Xm       , Md^Xm       
Uu          , Uu          , 1 Khr       , Chr         , Chr         , Uu          , Uu          , Uh          , Uh          , Uh          , Uh          , Uh          , Uh          , Md          , Md          , Md          , Md          , Md          , Md          , Uh          , Uh          , Uh^Dr       , Ql^Es       , Ql          , Ql          , Uh          , Uh          , Uue         , Uh          , Uh          , Ql          , Ql          , Qlf         , Qlf         , Qlf         , Qlf         , Qlf         , Qlf         , Qlf         , Qlf^Es      , Uh^Es       , Md^Xm       , Md^Xm       , Md^Xm       , Md^Xm       , Md^Xm       
Uu          , Uu          , Chr         , Chr         , Chr         , Chr         , Uu          , Uu^Vud      , Uh          , Uh          , Uh          , Uh          , Uh          , Uh          , Uh          , Uh          , Uh          , Uh          , Uh          , Uh          , Uh          , Uh^Dr       , Uh^Dr       , Ql^Es       , Ql          , Uh          , Uh          , Uue         , Uh          , Uh          , Ql          , Ql          , Qlf         , Qlf         , Qlf         , Qlf         , Qlf         , Qlf         , Uh          , Uh^Es       , Md^Xm       , Md^Xm       , Md^Xm       , Md^Xm       , Md^Xm       , Md^Xm       
Uu          , Uu          , Chr         , Chr         , Uu          , Uu          , Uu          , Rb          , Uh          , Uh          , Uh          , Uh          , Uh          , Uh          , Uh          , Uh          , Uh          , Uh          , Uh          , Uh          , Uh          , Uh          , Uh          , Uh          , Uh          , Ql          , Ql          , Ql^Bs|      , Ql          , Ql          , Ql          , Ql          , Qlf         , Qlf         , Qlf         , Qlf         , Qlf         , Qlf         , Uh          , Uh          , Mm          , Md^Xm       , Md^Xm       , Md^Xm       , Md^Xm       , Md^Xm       
Uu          , Uu          , Uu          , Uu          , Uu          , Uu          , Uh          , Rb          , Re          , Re          , Rb          , Uu^Vu       , Rb          , Uh          , Rb          , Re          , Rb          , Uh          , Rb          , Uh          , Rb          , Uh          , Rb          , Re          , Re          , Uh          , Uue         , Uue         , Uh          , Ql          , Ql^Es       , Ql          , Uh          , Qlf         , Qlf^Es      , Qlf         , Qlf^Es      , Qlf^Es      , Uh          , Uh          , Mm          , Mm          , Mm          , Mm          , Mm          , Md^Xm       
Uu          , Uu          , Uu          , Uu          , Uu          , Uh          , Uh          , Uh          , Re          , Rb          , Rb          , Re          , Uh          , Re          , Rb          , Rb          , Re          , Rb          , Re          , Re          , Rb          , Rb          , Uh          , Uh          , Uh          , Uue         , Uh          , Uu^Vu       , Uh          , Uh          , Uh          , Uh          , Uh          , Uh          , Uu          , Uh          , Uu          , Uh          , Uu          , Uu          , Uu          , Mm          , Uh          , Mm          , Mm          , Md^Xm       
Uh          , Uh          , Uh          , Uu          , Uh          , Uu^Vud      , Uh          , Uh          , Uh          , Uh          , Rb          , Rb          , Uh          , Uh          , Uh          , Uh          , Uh          , Uh          , Uh          , Re          , Re          , Re          , Uu^Vu       , Uh          , Uh          , Uue         , Uu          , Uu          , Uu          , Uu          , Uu          , Uu          , Uu          , Uu          , Xu          , Uu          , Xu          , Uu          , Xu          , Xu          , Xu          , Uu          , Uh          , Uh          , Md          , Mm          
Md          , Md          , Md          , Uh          , Uh          , Uh          , Uh          , Uh          , Uh          , Uh          , Re          , Rb          , Uh          , Uh          , Uh          , Uh          , Xu          , Xu          , Xu          , Xu          , Xu          , Xu          , Xu          , Uh          , Uh          , Uue         , Xu          , Xu          , Xu          , Xu          , Xu          , Xu          , Xu          , Xu          , Xu          , Xu          , Xu          , Xu          , Xu          , Xu          , Xu          , Uu          , Uu          , Uh          , Uh          , Mm          
Md          , Md          , Md          , Md          , Md          , Uh          , Uh          , Uh          , Uh          , Uh          , Uu^Vu       , Rb          , Rb          , Uh          , Uh          , Uh          , Xu          , Xu          , Xu          , Xu          , Xu          , Xu          , Xu          , Xu          , Xu          , Uue         , Xu          , Xu          , Xu          , Xu          , Xu          , Xu          , Xu          , Xu          , Xu          , Xu          , Xu          , Xu          , Xu          , Xu          , Xu          , Uh          , Uu          , Xu          , Xu          , Xu          
Md          , Md          , Md          , Md          , Uh          , Uh          , Uh          , Uh          , Uh          , Uh          , Uh          , Rb          , Rb          , Rb          , Uu^Vu       , Xu          , Xu          , Xu          , Xu          , Xu          , Xu          , Xu          , Xu          , Xu          , Uh          , Uue         , Uh          , Xu          , Xu          , Xu          , Xu          , Xu          , Xu          , Xu          , Xu          , Xu          , Xu          , Xu          , Xu          , Xu          , Uh          , Uh          , Uu          , Uh          , Uh          , Xu          
Md          , Md          , Md          , Md          , Uh          , Uh          , Uh          , Uh          , Uh          , Uh          , Uh          , Uh          , Uh          , Uh          , Xu          , Xu          , Xu          , Xu          , Xu          , Xu          , Xu          , Xu          , Uh          , Uh          , Uh          , Uue         , Uh          , Uh          , Uh          , Xu          , Xu          , Xu          , Xu          , Xu          , Xu          , Xu          , Xu          , Xu          , Xu          , Xu          , Uh          , Uh          , Rb          , Uu^Vu       , Rb          , Uh          
Md          , Md          , Uh          , Uh          , Uh          , Uh          , Uh          , Uh          , Uh          , Uh          , Uh          , Uh          , Uh          , Uh          , Xu          , Xu          , Xu          , Xu          , Xu          , Xu          , Uh          , Uh          , Uh          , Uh          , Uue         , Uue         , Uue         , Uh          , Uh          , Uh          , Uh          , Xu          , Xu          , Xu          , Xu          , Xu          , Xu          , Xu          , Xu          , Uh          , Uh          , Rb          , Re          , Rb          , Re          , Rb          
Uh          , Uh          , Uh          , Uh          , Urb         , Uh          , Uu          , Uh          , Uh          , Uh          , Uh          , Uh          , Uh          , Uh          , Uh          , Xu          , Xu          , Xu          , Uh          , Uh          , Uh          , Uh          , Uh          , Uh          , Uue         , Uue         , Uue         , Uh          , Uh          , Uh          , Uh          , Uh          , Uh          , Xu          , Xu          , Xu          , Xu          , Xu          , Uh          , Uh          , Re          , Rb          , Uu^Vu       , Rb          , Uh          , Uh          
Uh          , Uh          , Urb         , Urb         , Urb         , Urb         , Urb         , Uu          , Uu          , Uh          , Uh          , Uh          , Uh          , Uh          , Uh          , Xu          , Xu          , Xu          , Uh          , Uh          , Uh          , Uh          , Uh          , Uue         , Qxu         , Qxu         , Qxu         , Uue         , Uh          , Uh          , Uh          , Uh          , Uh          , Xu          , Xu          , Xu          , Uh          , Uh          , Rb          , Uh          , Re          , Rb          , Uh          , Uh          , Uh          , Xu          
Urb         , Urb         , Urb         , Urb         , Urb         , Urb         , Urb         , Uu          , Uu          , Uu          , Uu          , Uu          , Uu          , Uh          , Uu          , Uh          , Uu          , Uh          , Uu          , Uh          , Uu          , Uh          , Qxu         , Qxu         , Qxua        , Qxua        , Qxua        , Qxu         , Qxu         , Uh          , Uu          , Uh          , Uu          , Uh          , Uu          , Uh          , Rb          , Uu^Vu       , Re          , Re          , Rb          , Re          , Uh          , Uh          , Xu          , Xu          
Urb         , Urb         , Urb         , Urb         , Urb         , Urb         , Urb         , Urb         , Uu          , Uu          , Uu          , Uu          , Uu          , Uu          , Uu          , Uu          , Uu          , Uu          , Uu          , Uu          , Uu          , Uu          , Qxu         , Qxua        , Qxua        , Qxua        , Qxua        , Qxua        , Qxu         , Uu          , Uu          , Uu          , Uu          , Uu          , Uu          , Uu          , Re          , Re          , Re          , Rb          , Re          , Uh          , Uh          , Uh          , Xu          , Xu          
Urb         , Urb         , Urb         , Urb         , Urb         , Urb         , Urb         , Urb         , Uu          , Uu          , Uu          , Uu          , Uu          , Uu          , Uu          , Uu          , Uu          , Uu          , Uu          , Uu          , Uu          , Uu          , Qxu         , Qxua        , Qxua        , Qxua        , Qxua        , Qxua        , Qxu         , Uu          , Uu          , Uu          , Uu          , Uu          , Uu          , Rb          , Uh          , Uh          , Uh          , Uh          , Uu^Vu       , Uh          , Uh          , Xu          , Xu          , Xu          
Uh          , Urb         , Urb         , Urb         , Urb         , Urb         , Urb         , Uu          , Uu          , Uu          , Uh          , Uu          , Uh          , Uh          , Rb          , Uh          , Xu          , Uh          , Uh          , Uh          , Uh          , Uh          , Uh          , Qxu         , Qxu         , Qxua        , Qxu         , Qxu         , Uh          , Uh          , Uh          , Uh          , Uh          , Uh          , Xu          , Uh          , Uh          , Uu^Vu       , Uh          , Uh          , Uh          , Uh          , Xu          , Xu          , Xu          , Xu          
Md          , Uh          , Uh          , Urb         , Urb         , Urb         , Uu          , Uu          , Uh          , Uh          , Uh          , Uh          , Uh          , Rb          , Uh          , Xu          , Xu          , Xu          , Uh          , Uh          , Uh          , Uh          , Uh          , Ur          , Ur          , Qxu         , Ur          , Ur          , Uh          , Uh          , Uh          , Uh          , Uh          , Xu          , Xu          , Xu          , Xu          , Xu          , Xu          , Xu          , Xu          , Xu          , Xu          , Xu          , Xu          , Xu          
Md          , Md          , Uh          , Uh          , Cud         , Cud         , Cud         , Uh          , Uh          , Uh          , Uh          , Uh          , Rb          , Rb          , Uh          , Xu          , Xu          , Xu          , Xu          , Uh          , Uh          , Uh          , Uh          , Uh          , Ur          , Ur          , Ur          , Uh          , Uh          , Uh          , Uh          , Uh          , Xu          , Xu          , Xu          , Xu          , Xu          , Xu          , Xu          , Xu          , Xu          , Xu          , Xu          , Xu          , Xu          , Xu          
Md          , Md          , Md          , Cud         , Cud         , 2 Ko        , Cud         , Cud         , Uh          , Uh          , Uh          , Uh          , Rb          , Uh          , Uh          , Uh          , Uh          , Xu          , Xu          , Xu          , Xu          , Uh          , Uh          , Uh          , Uh          , Ur          , Uh          , Uh          , Uh          , Uh          , Xu          , Xu          , Xu          , Xu          , Xu          , Xu          , Xu          , Xu          , Xu          , Xu          , Xu          , Xu          , Xu          , Xu          , Xu          , Xu          
Md          , Md          , Md          , Md          , Md          , Md          , Uh          , Uh          , Uh          , Uh          , Rb          , Rb          , Uh          , Uh          , Uh          , Uh          , Uu          , Xu          , Xu          , Xu          , Xu          , Xu          , Xu          , Uh          , Uh          , Ur          , Uh          , Uh          , Xu          , Xu          , Xu          , Xu          , Xu          , Xu          , Xu          , Xu          , Xu          , Xu          , Xu          , Xu          , Xu          , Xu          , Xu          , Xu          , Xu          , Xu          
Md          , Md          , Md          , Md          , Uh          , Uh          , Rb          , Uh          , Re          , Rb          , Uu^Vu       , Re          , Re          , Uh          , Uh          , Uh          , Uh          , Uh          , Xu          , Xu          , Xu          , Xu          , Xu          , Xu          , Xu          , Ur          , Xu          , Xu          , Xu          , Xu          , Xu          , Xu          , Xu          , Xu          , Xu          , Xu          , Xu          , Xu          , Xu          , Xu          , Xu          , Xu          , Xu          , Xu          , Xu          , Xu          
Md          , Md          , Uu^Vu       , Uh          , Re          , Rb          , Uh          , Rb          , Uh          , Uh          , Uh          , Uh          , Uh          , Rb          , Rb          , Uh          , Uu^Vu       , Uh          , Uh          , Xu          , Xu          , Xu          , Xu          , Xu          , Uh          , Ur          , Uh          , Xu          , Xu          , Xu          , Xu          , Xu          , Xu          , Xu          , Xu          , Xu          , Xu          , Xu          , Xu          , Xu          , Xu          , Xu          , Xu          , Xu          , Xu          , Xu          
Md          , Uh          , Re          , Re          , Uh          , Uh          , Xuce        , Uh          , Xuce        , Uh          , Xuce        , Uh          , Xuce        , Uh          , Uh          , Rb          , Uh          , Uh          , Uh          , Uh          , Uh          , Uh          , Uh          , Uh          , Uh          , Ur          , Uh          , Uh          , Md          , Xu          , Xu          , Xu          , Xu          , Xu          , Xu          , Xu          , Xu          , Xu          , Xu          , Xu          , Xu          , Xu          , Xu          , Xu          , Xu          , Xu          
Uh          , Uh          , Re          , Uh          , Wog         , Uh          , Wog         , Xuce        , Xuce        , Xuce        , Xuce        , Xuce        , Xuce        , Xuce        , Uh          , Re          , Rb          , Uh          , Uh          , Uh          , Uh          , Uh          , Uh          , Uh          , Ur          , Ur          , Uh          , Uh          , Md          , Xu          , Xu          , Xu          , Xu          , Xu          , Xu          , Xu          , Xu          , Xu          , Xu          , Xu          , Xu          , Xu          , Xu          , Xu          , Xu          , Xu          
Wog         , Uh          , Wog         , Wog         , Wog         , Wog         , Wog         , Wog         , Wog         , Wog         , Wog         , Wog         , Xuce        , Xuce        , Uh          , Uu^Vu       , Re          , Uh          , Uh          , Uh          , Uh          , Uh          , Ur          , Ur          , Uh          , Uh          , Md          , Md          , Md          , Md          , Xu          , Xu          , Xu          , Xu          , Xu          , Xu          , Xu          , Xu          , Xu          , Xu          , Xu          , Xu          , Xu          , Xu          , Xu          , Xu          
Wog         , Wog         , Wog         , Wog         , Wog         , Wog         , Wog         , Wog         , Wog         , Wog         , Wog         , Wog         , Wog         , Xuce        , Xuce        , Uh          , Re          , Uh          , Uh          , Uh          , Ur          , Ur          , Uh          , Uh          , Md          , Md          , Md          , Md          , Md          , Md          , Md          , Xu          , Xu          , Xu          , Xu          , Xu          , Xu          , Xu          , Xu          , Xu          , Xu          , Xu          , Xu          , Xu          , Xu          , Xu          
Wog         , Wog         , Wog         , Wog         , Wog         , Wog         , Wog         , Wog         , Wog         , Wog         , Wog         , Wog         , Wog         , Xuce        , Xuce        , Uh          , Re          , Uh          , Uh          , Ur          , Uh          , Uh          , Uh          , Md          , Md          , Md          , Md          , Md          , Md          , Md          , Md          , Md          , Md          , Md          , Md          , Xu          , Xu          , Xu          , Xu          , Xu          , Xu          , Xu          , Xu          , Xu          , Xu          , Xu          
Wog         , Wog         , Wog         , Wog         , Wog         , Wog         , Wog         , Wog         , Wog         , Wog         , Wog         , Wog         , Wog         , Wog         , Chw         , Xuce        , Re          , Uh          , Wwg         , Wwg         , Wwg         , Uh          , Uh          , Uh          , Uh          , Md          , Uh          , Md          , Md          , Md          , Md          , Md          , Md          , Md          , Md          , Md          , Md          , Xu          , Xu          , Xu          , Xu          , Xu          , Xu          , Xu          , Xu          , Xu          
Wog         , Wog         , Wog         , Wog         , Wog         , Wog         , Wog         , Wog         , Wog         , Wog         , Wog         , Wog         , Wog         , Wog         , Chw         , Wwr         , Wwg         , Wwg         , Uh          , Wwg         , Uh          , Wwg         , Wwg         , Wwg         , Wwg         , Uh          , Wwg         , Uh          , Uh          , Md          , Uh          , Md          , Uh          , Md          , Md          , Md          , Md          , Md          , Xu          , Xu          , Xu          , Xu          , Xu          , Xu          , Xu          , Xu          
Wog         , Wog         , Wog         , Wog         , Wog         , Wog         , Wog         , Wog         , Wog         , Wog         , Wog         , Wog         , Xuce        , Wog         , Xuce        , Uh          , Uh          , Uh          , Uh          , Uh          , Uh          , Uh          , Uh          , Uh          , Uh          , Wwg         , Wwg         , Wwg         , Wwg         , Uh          , Uh          , Uh          , Wwg         , Uh          , Uh          , Md          , Md          , Md          , Xu          , Xu          , Xu          , Xu          , Xu          , Xu          , Xu          , Xu          
Wog         , Wog         , Wog         , Wog         , Wog         , Wog         , Wog         , Wog         , Wog         , Wog         , Xuce        , Xuce        , Xuce        , Xuce        , Uh          , Uh          , Uh          , Uh          , Uh          , Uh          , Uh          , Uh          , Uh          , Uh          , Uh          , Uh          , Uh          , Uh          , Uh          , Wwg         , Wwg         , Wwg         , Wwg         , Wwg         , Wwg         , Uh          , Uh          , Uh          , Uh          , Xu          , Uh          , Xu          , Uh          , Xu          , Xu          , Xu          
