border_size=1
usage=map

Qxu         , Qxu         , Qxu         , Qxu         , Qxu         , Qxu         , Qxu         , Qxu         , Qxu         , Qxu         , Qxu         , Qxu         , Qxu         , Qxu         , Ur          , Ur          , Ww          , Ur          , Ur          , Ww          , Ur          , Ur          , Ur          , Ww          , Ur          , Uue         , Uue         , Hhd         , Hhd         , Hhd         , Md          , Md          , Mm          , Gg          , Md          , Gg          , Mm          , Mm          , Mm          , Gg          , Mm          , Gg          , Mm          , Gg          , Mm          , Gg          , Mm          , Gg          
Qxu         , Qxu         , Qxu         , Qxu         , Qxu         , Qxu         , Xu          , Qxu         , Xu          , Qxu         , Xu          , Qxu         , Qxu         , Qxu         , Qxu         , Ur          , Ur          , Ww          , Ur          , Ww          , Ww          , Sm          , Ww          , Ww          , Ur          , Uue         , Re          , Uue         , Hhd         , Md          , Md          , Md          , Hhd         , Mm          , Md          , Md          , Md          , Mm          , Mm          , Mm          , Mm          , Mm          , Mm          , Mm          , Mm          , Mm          , Md          , Md          
Qxu         , Qxu         , Qxu         , Qxu         , Xu          , Xu          , Xu          , Xu          , Xos         , Xu          , Xu          , Xu          , Xu          , Qxu         , Qxu         , Qxu         , Ur          , Ww          , Sm          , Uu^Uf       , Ww          , Ww          , Ur          , Ur          , Qxu         , Uue         , Qxu         , Re          , Qxu         , Hhd         , Hhd         , Hhd         , Hhd         , Hhd         , Dd^Dc       , Md          , Uh          , Uh          , Dd^Dr       , Mm          , Uh          , Mm          , Mm          , Mm          , Md          , Md          , Md          , Md          
Qxu         , Qxu         , Qxu         , Xu          , Xu          , Xu          , Xos         , Xos         , Uu          , Xos         , Xos         , Xu          , Xu          , Qxu         , Qxu         , Qxu         , Ur          , Ww          , Ww^Vm       , Ww          , Ur          , Ur          , Qxu         , Qxu         , Qxu         , Qxu         , Qxu         , Qxu         , Qxu         , Qxu         , Qxu         , Uu          , Uu          , Hhd         , Uh          , Uh          , Uh          , Uh^Dr       , Uh^Dr       , Uh^Dr       , Uh^Dr       , Md          , Md          , Md          , Md          , Md          , Md          , Md          
Qxu         , Qxu         , Xu          , Xu          , Xos         , Xos         , Uu          , Ur          , Uue         , Uue         , Uue         , Xos         , Cud         , Xu          , Uh          , Ur          , Wwg         , Ww          , Ww          , Ww          , Ur          , Qxu         , Qxu         , Qxu         , Xos         , Qxu         , Cud         , Qxu         , Xos         , Qxu         , Qxu         , Qxu         , Uu          , Uh          , Uh          , Uh          , Uh          , Uh^Dr       , Mm          , Mv          , Md^Dr       , Uh^Dr       , Md          , Md          , Md          , Mm          , Md          , Md          
Aa          , Qxu         , Xu          , Xu          , Xos         , 3 Ko        , Uu          , Uu^Vu       , Ur          , Uu^Vu       , Uu          , Uu          , Qxu         , Wog         , Wog         , Wwg         , Wog         , Wog         , Ww          , Ww          , Ur          , Qxu         , Qxu         , Xos         , Cud         , Cud         , Cud         , Cud         , Cud         , Xos         , Qxu         , Qxu         , Uu          , Uh          , Uh          , Dd^Dr       , Uh          , Uh^Dr       , Uh^Dr       , Mm^Es       , Qlf^Es      , Md^Dr       , Md          , Md          , Md          , Md          , Md          , Md          
Ha          , Qxu         , Qxu         , Xu          , Xu          , Xos         , Xos         , Ur          , Ur          , Uu          , Xos         , Cud         , Qxu         , Ur          , Ww          , Wog         , Wog         , Ww          , Ww          , Ur          , Qxu         , Qxu         , Qxu         , Xos         , Cud         , Rr^Vd       , Cud         , Rr^Vd       , Cud         , Xos         , Qxu         , Qxu         , Qxu         , Uu          , Uh          , Uh          , Uh          , Uh          , Uh          , Uh^Dr       , Qlf         , Uh^Dr       , Qlf         , Uh          , Uh          , Md          , Md          , Md          
Ms          , Ha          , Qxu         , Xu          , Xu          , Xu          , Xu          , Xos         , Xos         , Xos         , Xu          , Xu          , Qxu         , Ur          , Ww^Bw\      , Wog         , Ww          , Ww          , Chr         , Ur          , Qxu         , Qxu         , Cud         , Cud         , Xos         , Cud         , Ko          , Cud         , Xos         , Cud         , Cud         , Qxu         , Qxu         , Uu          , Uue         , Uh          , Uh          , Uh          , Dd^Dc       , Uh          , Md          , Qlf         , Uh          , Qlf         , Qlf         , Uh^Dr       , Uh^Dr       , Md          
Ms          , Ha          , Ha          , Qxu         , Qxu         , Xu          , Xu          , Xu          , Xu          , Xu          , Qxu         , Qxu         , Ur          , Ur          , Wwg         , Wog^Bw\     , Ur          , Ur          , Qxu^Bs\     , Qxu         , Qxu         , Qxu         , Qxu^Bs|     , Qxu         , Qxu         , Xos         , Xos         , Xos         , Qxu         , Qxu         , Qxu^Bs|     , Qxu         , Qxu         , Uu          , Uue         , Uue         , Hhd         , Hhd         , Hhd         , Md          , Mm          , Md          , Mm          , Uh          , Uh          , Qlf         , Qlf         , Uh          
Ms          , Ms          , Ha          , Qxu         , Qxu         , Qxu         , Qxu         , Qxu         , Qxu^Es      , Qxu         , Ur          , Ur          , Wwg         , Wwg         , Wwg         , Wwg         , Aa          , Qxu         , Qxu         , Qxu^Bs\     , Qxu^Bs\     , Qxu         , Qxu^Bs|     , Qxu         , Qxu         , Qxu         , Qxu         , Qxu         , Qxu         , Qxu         , Qxu^Bs|     , Qxu         , Qxu         , Uu          , Uu          , Uue         , Hhd         , Hhd         , Md          , Md          , Mm          , Mm          , Md          , Md          , Md          , Uh          , Qlf         , Uh          
Ms^Xm       , Ms          , Ms          , Ha          , Aa          , Qxu         , Aa          , Aa          , Ha          , Ha          , Wwr         , Wwr         , Mm          , Wwg         , Ha          , Aa          , Ha          , Qxu^Es      , Ms^Xm       , Ha          , Ha          , Qxu^Bs\     , Uu          , Cud         , Xos         , Xuc         , Xuc         , Xuc         , Xos         , Cud         , Uu          , Qxu         , Qxu         , Qxu         , Uh          , Uue         , Md          , Md          , Md          , Md          , Md          , Mm          , Mm          , Md          , Md          , Uh          , Qlf         , Uh          
Ms^Xm       , Ms^Xm       , Ha          , Ha          , Ha          , Aa          , Ha^Ii       , Ha          , Ai          , Wwr^Ii      , Ha^Ii       , Ai          , Ha          , Ha          , Ha          , Ha          , Ha          , Ha          , Ms          , Aa^Voa      , Ms          , Qxu^Ii      , Cud         , Urb         , Urb         , Xos         , Xos         , Xos         , Urb         , Urb         , Cud         , Qxu^Bs\     , Qxu^Bs\     , Qxu^Es      , Md          , Md          , Md          , Md          , Md          , Md          , Qlf         , Uh          , Uh          , Uh          , Uh          , Uh          , Qlf         , Uh          
Ms^Xm       , Ms^Xm       , Ha          , Ha          , Ms^Ii       , Ha^Ii       , Ai^Ii       , Ai          , Ms          , Ha^Ii       , Ms          , Ai          , Ms          , Ms          , Ms          , Ms          , Ms          , Ms          , Ms^Xm       , Ms          , Ms          , Ms^Xm       , Xuc         , Xos         , Rr^Vd       , Urb         , 6 Urb       , Urb         , Rr^Vd       , Xos         , Xuc         , Md^Xm       , Md^Xm       , Uu          , Mm^Xm       , Md          , Md          , Md          , Qlf         , Qlf         , Uh          , Qlf         , Qlf         , Qlf         , Qlf         , Qlf         , Uh^Dr       , Uh          
Ms^Xm       , Ms^Xm       , Ms          , Ms^Ii       , Ms^Ii       , Ms^Ii       , Ha^Ii       , Ms^Ii       , Ms^Xm       , Ms          , Ms          , Ms          , Ms          , Ms          , Ms          , Ms          , Ms          , Ms^Xm       , Ms^Xm       , Ms^Xm       , Ms^Xm       , Ms          , Xuc         , Xos         , Xos         , Urb         , Urb         , Urb         , Xos         , Xos         , Xuc         , Md^Xm       , Qlf^Es      , Qlf^Bs|     , Qlf^Es      , Mm^Xm       , Qlf^Es      , Qlf^Es      , Uh          , Uh          , Md          , Uh          , Uh          , Uh          , Uh          , Uh^Dr       , Md          , Md          
Ms^Xm       , Ha          , Ms^Xm       , Ms          , Ms^Xm       , Ms^Xm       , Ha^Ii       , Ms^Xm       , Ms^Xm       , Ms^Xm       , Ms^Xm       , Ms^Xm       , Ms^Xm       , Ms^Xm       , Ms^Xm       , Ms          , Ms^Xm       , Ms^Xm       , Ms^Xm       , Qxua^Es     , Qxua^Ii     , Qxua^Ii     , Qxua        , Xuc         , Xuc         , Urb         , Urb         , Urb         , Xuc         , Xuc         , Qlf^Es      , Qlf^Es      , Mm^Xm       , Uu          , Mm^Xm       , Qlf^Es      , Mm^Xm       , Uh          , Md          , Md          , Md          , Md          , Md          , Md          , Md          , Md          , Md          , Md          
Ms^Xm       , Ms^Xm       , Ms          , Ms^Xm       , Ms^Xm       , Ms^Xm       , Ai^Ii       , Ms^Ii       , Ms          , Ms          , Ms^Ii       , Ms^Ii       , Ms^Ii       , Ms          , Ms          , Ms^Xm       , Ms^Xm       , Ms^Xm       , Qxua^Efm    , Qxua^Ii     , Qxua        , Qxua        , Qxu         , Qxu         , Qxu         , Cud         , Cud         , Cud         , Qlf         , Qlf^Es      , Qxu         , Qxu         , Mm^Xm       , Uue         , Uue         , Mm^Xm       , Md          , Md          , Md          , Md          , Md^Xm       , Md          , Md          , Md          , Md          , Md          , Md          , Md          
Ms^Xm       , Ha          , Ms          , Ms          , Ms^Xm       , Ms^Xm       , Ms^Ii       , Ai          , Ms          , Ms          , Ms          , Ms          , Ha^Fda      , Ms          , Ms          , Ms          , Ha          , Ha          , Qxua^Es     , Qxua        , Qxu         , Qxu         , Rb          , Qxu         , Qxu         , Qxu         , Ql          , Ql          , Qxu         , Qxu         , Uh          , Ms^Xm       , Mm          , Mm          , Uu          , Md^Xm       , Md^Xm       , Md          , Mm          , Mm          , Md^Xm       , Mm          , Mm          , Md          , Md          , Md          , Md          , Md          
Ms^Xm       , Ha          , Ha^Dr       , Ms          , Ha^Fda      , Ms          , Ha^Fda      , Wwr         , Wwr         , Ha^Fda      , Ha^Fda      , Ha^Fda      , Ha^Fda      , Ha^Fda      , Ha          , Ha^Dr       , Ha^Dr       , Ha          , Aa          , Aa          , Aa          , Re          , Hhd         , Rb          , Qxu         , Qxua        , Qxu         , Qxu         , Uh          , Uh          , Mm          , Mm          , Mm          , Mm          , Uu          , Md^Xm       , Md^Xm       , Md^Xm       , Md          , Md^Xm       , Md          , Md^Xm       , Md^Xm       , Mm          , Mm          , Mm          , Mm          , Mm          
Ha          , Ha          , Ha^Dr       , Ha          , Ha          , Ha^Fda      , Ha^Fda      , Wwr         , Wwg         , Ai          , Wwg         , Ha^Fda      , Ha^Fda      , Ha^Fda      , Ha          , Ha          , Ha          , Ha^Dr       , Ha^Fda      , Aa          , Aa          , Hhd         , Hhd         , Rb          , Rb          , Qxu         , Uh          , Uh          , Mm          , Mm          , Mm          , Mm          , Md          , Mm          , Mm          , Ur          , Md^Xm       , Md^Xm       , Hhd^Dr      , Mm          , Md          , Md          , Md          , Md^Xm       , Md^Xm       , Mm          , Md^Xm       , Md^Xm       
Hh          , Hh          , Hh^Dr       , Ha          , Hhd^Fdw     , Ha^Fda      , Aa^Fpa      , Aa^Fma      , Aa^Fma      , Wwg         , Ww          , Ww          , Ha^Fda      , Ha^Fda      , Aa^Fma      , Ha          , Ha          , Ha^Dr       , Re^Dr       , Uue         , Re          , Re          , Re          , Hhd         , Hhd         , Hhd         , Mm          , Mm          , Mm          , Mm          , Md^Xm       , Md          , Md          , Mm          , Mm          , Re          , Rb          , Mm          , Hhd^Es      , Mm          , Mm          , Md          , Md          , Md          , Md          , Md^Xm       , Md          , Md          
Hh          , Hh^Es       , Hhd^Fdw     , Hh^Es       , Hh^Es       , Hhd^Fdw     , Hhd^Fdw     , Aa^Fma      , Hhd^Fmw     , Aa^Fma      , Ww          , Ww^Vm       , Hhd^Fdw     , Ha^Fda      , Hhd^Fdw     , Hhd^Fdw     , Hhd^Fmw     , Uu          , Rb^Es       , Rb^Es       , Rb^Es       , Rb          , Gll         , Hhd         , Hhd         , Mm          , Mm          , Mm          , Md^Xm       , Md^Xm       , Md^Xm       , Md^Ii       , Md          , Md          , Md          , Mm          , Hhd^Dr      , Re^Es       , Re^Es       , Rr^Vd       , Hhd^Dr      , Mm          , Mm          , Md          , Md          , Md          , Md          , Md          
Hh          , Hhd^Fdw     , Hh^Vhh      , Hhd^Fmw     , Hh          , Hhd^Fmw     , Hhd^Fmw     , Hhd^Fmw     , Hhd^Fdw     , Gd^Fmw      , Ww          , Ww          , Hhd^Fmw     , Hhd^Fdw     , Hhd^Fmw     , Hhd^Fmw     , Gd^Fmw      , Hhd^Fmw     , Re          , Re          , Gll         , Gll^Es      , Gll         , Gd          , Gd          , Hhd         , Hhd         , Md          , Mm          , Mm          , Mm          , Md^Xm       , Md          , Md          , Md          , Md          , Md          , Hhd^Es      , Hhd         , Re^Es       , Re^Es       , Hhd^Dr      , Mm          , Mm          , Mm          , Md          , Md          , Md          
Hhd^Fmw     , Hh          , Gll^Es      , Hh          , Hhd         , Hhd^Fdw     , Hhd^Fdw     , Hhd^Fmw     , Gd^Fmw      , Gd^Fmw      , Ww          , Ww          , Gs^Fdw      , Hhd^Fdw     , Hhd^Fmw     , Hhd^Fdw     , Gd^Fmw      , Gll^Fp      , Gll^Fp      , Gd          , Re^Vct      , Gll         , Gll         , Gd          , Gd          , Gd          , Hhd         , Md          , Md          , Mm          , Mm          , Md          , Mm          , Mm          , Md          , Md          , Uh          , Rr^Vd       , Hhd         , Hhd         , Re          , Hhd         , Hhd         , Mm          , Mm          , Mm          , Mm          , Md          
Gll^Es      , Gll^Es      , Gll^Es      , Gd^Fmw      , Gd^Fmw      , Gd^Fmw      , Hhd^Fdf     , Gd^Fmw      , Ww          , Wwf         , Ww          , Ww          , Gd^Fmw      , Hhd^Fmw     , Gd^Fmw      , Hhd^Fdf     , Gd^Fmw      , Gs^Fdw      , Gll^Fp      , Gd          , Gll         , Gll         , Gll         , Gd          , Re^Vct      , Gd          , Gd          , Hhd         , Md          , Md          , Md          , Mm          , Md          , Md          , 5 Khr       , Chr         , Chr         , Rr          , Uue         , Hhd         , Re          , Hhd         , Hhd         , Hhd         , Hhd         , Rr^Vd       , Mm          , Mm          
Gll         , Gs^Vc       , Gll         , Gll^Es      , Gd^Fmw      , Gs^Fdw      , Gd^Fmw      , Gs^Fdw      , Ww^Vm       , Ww          , Gs^Fdw      , Gd^Fmw      , Gs^Fdw      , Gd^Fmw      , Ww^Vm       , Gd^Fmw      , Gd^Fmw      , Gs^Fdw      , Gs^Fdw      , Gll^Fp      , Gd          , Gll         , Gd          , Gd          , Gd          , Gd          , Gd          , Hhd         , Hhd         , Md          , Rr^Vd       , Md          , Uh          , Chr         , Chr         , Chr         , Uh          , Rr          , Uue         , Uue         , Re          , Uue         , Uue         , Hhd         , Hhd         , Hhd         , Md          , Md          
Gll         , Gll         , Gll         , Gll         , Gll         , Gd^Fmw      , Gs^Fdw      , Gs^Fdw      , Ww          , Ww          , Ww          , Gs^Fdw      , Ww          , Ww          , Ww          , Ww          , Ww          , Gs^Fdw      , Gd^Fmw      , Gd^Fmw      , Gll^Fp      , Gd          , Gd          , Gd          , Gd          , Gd          , Gd          , Gd          , Gll         , Hhd         , Hhd         , Hhd         , Hhd         , Uh          , Uh          , Uh          , Uue         , Rr          , Uue         , Uue         , Rb          , Uue         , Rr^Vd       , Uue         , Hhd         , Hhd         , Hhd         , Md^Xm       
Gll         , Ss          , Sm          , Gs^Vht      , Gll         , Gd^Fmw      , Gd^Fmw      , Gd^Fmw      , Gd^Fmw      , Ww          , Ww          , Ww          , Wwf         , Wwf         , Sm          , Wwf         , Ww          , Ww          , Ww          , Gs^Fdw      , Gll^Fp      , Gll^Fmf     , Gll^Fmf     , Gd          , Gd          , Gd          , Gd          , Gd^Vo       , Gd          , Gs          , Gs          , Gs          , Uue         , Uue         , Uue         , Uue         , Hhd         , Rr^Vd       , Rr          , Uue         , Rb          , Rr          , Uue         , Uue         , Hhd         , Rr^Vd       , Md          , Md^Xm       
Sm          , Gll         , Sm          , Sm          , Sm          , Sm          , Gll^Fp      , Gd^Fmw      , Gd^Fmw      , Gd^Fmw      , Sm          , Ww          , Sm          , Sm          , Ss          , Gd^Fmw      , Gd^Fmw      , Ww          , Ww          , Gs^Fdw      , Gll^Fp      , Gll^Fmf     , Gll^Fmf     , Gd          , Gll         , Gll         , Gd          , Gd          , Gd          , Gd          , Gd          , Gs          , Gs          , Uue         , Uue         , Hhd         , Md          , Hhd         , Uue         , Rb          , Uue         , Uue         , Uue         , Uue         , Rr^Vd       , Hhd         , Mm          , Md^Xm       
Ss          , Sm          , Ss          , Sm          , Ss          , Ss          , Ss          , Gll^Fmf     , Ss          , Gd^Fmw      , Ss          , Sm          , Ss          , Ss          , Ss          , Gs^Fdw      , Gd^Fmw      , Ww          , Ww          , Gs^Fdw      , Gll^Fmf     , Gll^Fmf     , Gll^Fmf     , Gd^Fdf      , Gll         , Gll         , Gd          , Gd          , Gd          , Gd          , Gd          , Gd          , Gd          , Gd          , Uue         , Rr^Vd       , Hhd         , Hhd         , Uue         , Rb          , Uue         , Uue         , Hhd         , Hhd         , Hhd         , Hhd         , Md          , Md^Xm       
Ss          , Ss          , Ss          , Sm          , Sm          , Ss^Vhs      , Ss          , Ss          , Ss          , Ss          , Sm          , Sm          , Ss          , Ss          , Gd^Fmw      , Gs^Fdw      , Ww          , Ww          , Ww          , Gs^Fdw      , Gll^Fmf     , Gs^Vc       , Gd^Fmw      , Gd^Fdf      , Gs          , Gll         , Gll         , Gd^Vo       , Gd          , Gd          , Gd          , Gd          , Gd          , Gd          , Uue         , Uue         , Uue         , Uue         , Uue         , Rb          , Uue         , Hhd         , Md          , Md          , Md          , Md          , Md^Xm       , Md^Xm       
Ss          , Ss          , Ss          , Ss          , Ss          , Ss          , Ss          , Ss          , Sm          , Ss          , Ss          , Ss          , Gd^Fmw      , Gd^Fmw      , Ww^Vm       , Ww          , Ww          , Ww          , Gll^Fmf     , Gll^Fmf     , Gd^Fmw      , Gd^Fmw      , Gd^Fmw      , Gd^Fdf      , Gd^Fdf      , Gll         , Gll         , Gll         , Gll         , Gll         , Gll         , Gd          , Gll         , Gll         , Hhd         , Hhd         , Hhd         , Hhd         , Hhd         , Re          , Re          , Uue         , Co          , Xu          , Xu          , Md          , Xu          , Md^Xm       
Sm          , Ss          , Sm          , Ss^Vm       , Sm          , Ss          , Ss          , Sm          , Sm          , Ss^Vhs      , Ss          , Ss          , Gd^Fmw      , Gd^Fmw      , Ww          , Ww          , Gll^Fmf     , Gll^Fmf     , Gll^Fp      , Gll^Fp      , Gd^Fmw      , Gd^Fmw      , Hhd^Fdf     , Gd^Fmw      , Gll^Fmf     , Gs          , Gll         , Gll         , Gll         , Gll         , Gd^Vo       , Gll         , Hh          , Hhd         , Mm          , Hhd         , Mm          , Hhd         , Md          , Hhd         , Uu          , Rb          , Uu          , Xu          , Xu          , Xu          , Xu          , Xu          
Ss          , Ss          , Ss          , Sm          , Ss          , Ss          , Ss          , Ss          , Ss          , Ss          , Ss          , Gll^Fmf     , Gd^Fmw      , Gll^Fmf     , Ww          , Ww          , Gll^Fmf     , Gll^Fp      , Gll^Fp      , Gll^Fp      , Gs^Fds      , Gd^Fmw      , Hhd^Fdf     , Gd^Fdf      , Gd^Fdf      , Gs          , Gll         , Gll         , Gll         , Gll         , Gll         , Gll         , Hh          , Hhd         , Mm          , Mm          , Md          , Md          , Xu          , Xu          , Xu          , Rb          , Rb          , Uu          , Uu          , Uu          , Xu          , Xu          
Ss          , Ss          , Sm          , Ss          , Ss^Vm       , Sm          , Sm          , Ss          , Sm          , Ss          , Gll^Fp      , Gs^Fms      , Gd^Fmw      , Wwf         , Ww          , Ww          , Gll^Fmf     , Gll^Fp      , Gs^Fds      , Gs^Vc       , Gll^Fp      , Hhd^Fdf     , Gd^Fmw      , Gll^Fmf     , Gd^Fdf      , Gs^Vc       , Gs          , Gll         , Gll         , Gll         , Gs          , Gs          , Hh          , Hhd         , Wwt         , Md          , Md          , Xu          , Xu          , Xu          , Uu          , Uu          , Ce          , Ce          , Ce          , Uu          , Uu          , Xu          
Ss          , Chs         , Chs         , Ss          , Sm          , Ss          , Ss          , Sm          , Ss^Vm       , Ss          , Gll^Fp      , Gs^Fms      , Gs^Fms      , Ww          , Ww^Vm       , Gd^Fmw      , Gd^Fmw      , Gd^Fdf      , Gll^Fp      , Gs^Fds      , Gs^Fds      , Gll^Fp      , Gd^Fmw      , Gd^Fmw      , Gd^Fdf      , Gll^Fmf     , Hhd^Fmf     , Ce          , 2 Ke        , Ce          , Wwr         , Hh          , Wwr         , Wwr         , Md          , Md          , Md^Xm       , Xu          , Xu          , Uu          , Uu^Vu       , Uu          , Ce          , Ce          , Ce          , Ce          , Uu          , Xu          
Ss          , Chs         , 4 Khs       , Chs         , Sm          , Ss          , Ss          , Sm          , Sm          , Ss          , Gll^Fp      , Gs^Fms      , Gs^Fms      , Ww          , Ww          , Wwf         , Wwf         , Gd^Fmw      , Ww          , Gll^Fp      , Wwf         , Gll^Fp      , Gd^Fmw      , Gd^Fmw      , Gd^Fmw      , Gll^Fmf     , Hhd^Fmf     , Ce          , Wwt         , Wwt         , Hh          , Wwr         , Hhd         , Mm          , Md          , Md          , Xu          , Xu          , Xu          , Uu          , Uu          , Uu          , Ce          , 1 Ke        , Ce          , Ce          , Uu          , Uu          
Ss          , Sm          , Sm          , Chs         , Ss          , Sm          , Ss          , Ss          , Ss          , Ss          , Ss          , Gll^Fp      , Gs^Fms      , Gs^Fms      , Gs^Fms      , Ww          , Ww          , Ww          , Ww          , Wwg         , Wwr         , Wo          , Wo          , Wo          , Wo          , Wo          , Wwr         , Wwr         , Hhd^Fmf     , Hhd^Fmf     , Hh          , Hhd         , Mm          , Mm^Xm       , Md          , Md^Xm       , Xu          , Xu          , Uu          , Uu          , Uu^Vu       , Uu          , Ce          , Ce          , Uu          , Uu          , Uu^Vu       , Uu          
Ss          , Ss          , Ss          , Ss          , Ss          , Ss          , Ss          , Ss          , Ss          , Ss          , Ss          , Ss          , Ss          , Gs^Fms      , Gs^Fms      , Gs^Fds      , Ww          , Ww          , Ww          , Ww          , Ww          , Gs^Fds      , Gs^Fds      , Gll^Fp      , Gll^Fp      , Hh^Fds      , Hh^Fds      , Gd^Fdf      , Gd^Fdf      , Hhd^Fmf     , Hh          , Hhd         , Md          , Md          , Md^Xm       , Xu          , Xu          , Xu          , Xu          , Uu          , Uu          , Uu          , Uu          , Uu          , Uu          , Uu          , Uu          , Uu          
