border_size=1
usage=map

Hh          , Hh          , Hh          , Hh          , Hh          , Rr          , Rr          , Hh          , Hh          , Hh          , Hh          , Hh          , Hh          , Hh          , Hh          , Hh          , Hh          , Hh          , Hh          , Hh          , Hh          , Hhd         , Hhd         , Hhd         , Md          , Md          , Md          , Md          , Md          , Md          , Md          , Md          , Md          , Md          , Md          , Md          , Md          , Md          , Md          , Md          , Md          , Md          , Md          , Md          , Md          , Md          
Mm          , Hh          , Hh^Fp       , Hh^Fp       , Hh          , Hh          , Hh          , Rr          , Rr          , Hh          , Gg^Gvs      , Gg^Gvs      , Gg^Gvs      , Gg^Gvs      , Gg^Gvs      , Hh          , Gg          , Hh          , Hh          , Hh          , Hhd         , Hhd         , Hhd         , Hhd         , Md          , Md          , Md          , Md          , Md          , Md          , Md          , Md          , Md          , Md          , Md          , Md          , Md          , Md          , Md          , Md          , Md          , Md          , Md          , Md          , Md          , Md          
Mm          , Hh          , Hh          , Hh^Fp       , Hh^Fp       , Hh          , Hh^Fp       , Hh          , Gg^Gvs      , Rr          , Rr          , Gg^Gvs      , Gs          , Gs^Gvs      , Re^Gvs      , Gs^Gvs      , Gs          , Hh          , Hh          , Hh          , Hh          , Hhd         , Hhd         , Hhd         , Md          , Md          , Md          , Md          , Md          , Md          , Md          , Md          , Md          , Md          , Md          , Md          , Md          , Md          , Md          , Md          , Md          , Md          , Md          , Md          , Md          , Md          
Mm          , Mm          , Hh          , Hh^Fp       , Hh^Fds      , Hh^Fp       , Hh^Fp       , Hh          , Gg^Gvs      , Gg^Gvs      , Gs^Gvs      , Rr          , Rp          , Gs          , Gs          , Re          , Ce          , Ce          , Ce          , Hh          , Hh          , Hh          , Hhd         , Hhd         , Md          , Md          , Md          , Md          , Md          , Md          , Md          , Md          , Md          , Md          , Md          , Md          , Md          , Md          , Md          , Md          , Md          , Md          , Md          , Md          , Md          , Md          
Mm          , Mm          , Hh          , Hh          , Hh^Fds      , Hh^Fds      , Hh^Fp       , Hh^Fp       , Gg^Gvs      , Gg^Gvs      , Gs^Gvs      , Gs          , Gd          , Rp          , Gs^Es       , Ce          , Ce          , 5 Ke        , Ce          , Ce          , Hh^Es       , Hh          , Hhd         , Hhd         , Hhd         , Md          , Md          , Md          , Hhd         , Hhd         , Md          , Md          , Md          , Md          , Md          , Md          , Md          , Md          , Md          , Md          , Md          , Md          , Md          , Md          , Md          , Md          
Hh^Fds      , Hh^Fds      , Hh^Fds      , Hh^Fds      , Hh^Fds      , Hh^Fp       , Gs^Fds      , Gs^Fds      , Gg^Gvs      , Gg^Gvs      , Gs          , Gs          , Gs          , Rp          , Gd          , Gs^Vdt      , Ce          , Ce          , Ce          , Rd^Vdt      , Gs          , Hh          , Hh          , Hhd         , Hhd         , Hhd         , Hhd         , Hhd         , Hhd         , Md          , Md          , Md          , Md          , Md          , Md          , Md          , Md          , Md          , Md          , Md          , Md          , Md          , Md          , Md          , Md          , Md          
Hh^Fp       , Hh^Fp       , Gs^Fms      , Hh^Fds      , Gs^Fms      , Gs^Fms      , Gs^Fds      , Gs^Fds      , Gs^Fds      , Gg^Gvs      , Gg^Gvs      , Gs          , Gs^Es       , Rp          , Gs^Gvs      , Gs^Gvs      , Gs^Gvs      , Gs          , Gs          , Gs          , Gg          , Gg          , Hh          , Hhd         , Hh          , Hhd         , Hh          , Hh          , Hh          , Md          , Md          , Md          , Md          , Md          , Md          , Md          , Hhd^Dr      , Md          , Hhd^Dr      , Hhd^Dr      , Md          , Md          , Md          , Md          , Md          , Md          
Hh^Fp       , Hh^Fp       , Gs^Fms      , Gs^Fms      , Gs^Fms      , Gs^Fms      , Gs^Fms      , Gs^Fds      , Gs^Fds      , Gll^Fp      , Gs^Fds      , Gg^Gvs      , Gs^Gvs      , Rr          , Gg^Gvs      , Gg^Gvs      , Gg^Gvs      , Gg^Gvs      , Gg          , Gs          , Gs          , Gg          , Gg          , Hh          , Gg          , Hh          , Hh          , Hh          , Hh          , Md          , Md          , Md          , Md          , Md          , Hh^Vhh      , Hhd^Dr      , Hhd         , Hhd^Dr      , Hhd         , Hhd         , Md          , Md          , Md          , Md          , Md          , Md          
Hh^Fp       , Hh^Fp       , Gs^Fms      , Gs^Fms      , Gll^Fp      , Gs^Fms      , Gs^Fms      , Gs^Fms      , Gs^Fds      , Gs^Fds      , Gs^Fds      , Gll^Fp      , Gg^Gvs      , Rr          , Gs^Vhr      , Gs^Esd      , Gg^Gvs      , Gg^Gvs      , Gg          , Gg          , Gg          , Gg          , Gg          , Gg          , Gg          , Gg          , Gs          , Hh          , Hh          , Hh          , Hh          , Md          , Hhd         , Hhd         , Hhd^Dr      , Re          , Re          , Hhd         , Re          , Hh^Vhh      , Md          , Md          , Md          , Md          , Md          , Md          
Hh^Fp       , Hh^Fp       , Gs^Fms      , Gs^Fms      , Gll^Fp      , Gs^Fms      , Gs^Fds      , Gll^Fp      , Gll^Fp      , Gs^Fds      , Gg^Gvs      , Gg^Gvs      , Gg^Gvs      , Rr          , Gg          , Gs^Es       , Gg          , Gg^Gvs      , Gg          , Gg          , Gg^Gvs      , Gg          , Gg          , Gg          , Gg          , Gs          , Gs          , Gs          , Gs          , Hh          , Hh          , Hh          , Hh          , Hh^Dr       , Hhd^Dr      , Hhd^Dr      , Re          , Re          , Hhd^Dr      , Hhd^Dr      , Md          , Md          , Md          , Md          , Md          , Md          
Hh^Fp       , Hh^Fp       , Hh^Fp       , Gs^Fds      , Gs^Fds      , Gs^Fds      , Gs^Fds      , Gs^Fds      , Gg^Gvs      , Gg^Gvs      , Gg^Gvs      , Gg^Gvs      , Gg^Gvs      , Rr          , Ce          , Gg          , Gg          , Gg          , Gg^Gvs      , Gg^Gvs      , Gg^Gvs      , Gg^Gvs      , Gg^Gvs      , Gg          , Gg          , Gg          , Gg          , Gs          , Gs          , Hh          , Wwr         , Rd          , Rd          , Hhd^Dr      , Re          , Re          , Hhd^Dr      , Hhd^Dr      , Hhd         , Md          , Md          , Md          , Md          , Md          , Md          , Md          
Hh^Fp       , Hh^Fp       , Hh^Fp       , Gll^Fp      , Gll^Fp      , Gll^Fp      , Gs^Fds      , Gs^Fds      , Gs^Fds      , Gg^Gvs      , Gg^Gvs      , Gg^Gvs      , Ce          , Rr          , Rp          , Gg^Wm       , Gg^Gvs      , Gg^Gvs      , Gg^Gvs      , Gg^Gvs      , Gg^Gvs      , Gg^Gvs      , Gg          , Gg          , Wwt         , Wwt         , Wwt         , Gs          , Wwt         , Wwr         , Wwt         , Wwr         , Rd          , Rd          , Re          , Hhd         , Hhd         , Hhd         , Md          , Md          , Md          , Md          , Md          , Md          , Md          , Md          
Hh^Fp       , Hh^Fp       , Gll^Fp      , Gll^Fp      , Gs^Fds      , Gs^Fds      , Gs^Fds      , Gs^Fds      , Gs^Fds      , Gs^Fds      , Gg          , Gg          , Rp          , Rp          , Gs^Vl       , Rp          , Rp          , Gg^Gvs      , Gg^Gvs      , Gg^Gvs      , Gg          , Gg          , Wwt         , Wwt         , Ww          , Ww          , Ww          , Wwt         , Ww          , Ww          , Ww          , Wwt         , Wwt^Bsb/    , Re          , Rd          , Hh          , Hh          , Hh          , Hhd         , Md          , Md          , Md          , Md          , Md          , Wwr         , Md          
Gll^Fp      , Hh^Fp       , Gll^Fp      , Gll^Fp      , Gs^Fds      , Gs^Fds      , Gs^Fds      , Gs^Fds      , Gg          , Gg          , Rp          , Rp          , Gg          , Gg          , Gg^Gvs      , Gg^Gvs      , Gg^Gvs      , Rp          , Rp          , Gg          , Rr^Vhc      , Wwt         , Ww          , Ww          , Chr         , Ch          , Ch          , Ww          , Ch          , Ch          , Rrc         , Wwt^Bsb/    , Ww          , Wwt         , Wwr         , Rp          , Rp          , Hh          , Hhd         , Hhd         , Hhd         , Md          , Ww          , Wwr         , Md          , Wwr         
Gll^Fp      , Gll^Fp      , Gs^Fds      , Gs^Fds      , Gs^Fds      , Gs^Fds      , Rp          , Gs^Vl       , Rp          , Rp          , Rp          , Gg          , Gg          , Gg^Gvs      , Gg^Gvs      , Gg^Gvs      , Gg^Wm       , Gg^Gvs      , Gg^Gvs      , Rp          , Wwt^Bw\     , Wwt         , Ww          , Chr         , Rrc         , Rrc         , Rrc         , Ch          , Rr          , Rrc         , Rr^Vhc      , Ch          , Ww          , Wwt         , Gs          , Gs          , Rp          , Gg          , Ww          , Hhd         , Wwr         , Wwr         , Md          , Md          , Md          , Md          
Gs^Fds      , Gs^Fds      , Gs^Fds      , Gs^Fds      , Gs^Fds      , Gs^Fds      , Gg          , Rp          , Gg          , Gg          , Gg^Gvs      , Rp          , Rp          , Gs^Vh       , Gg          , Gg^Gvs      , Gg^Gvs      , Gg^Gvs      , Wwt         , Wwt         , Ww          , Wwt^Bw\     , Wot^Bw\     , Rb^Dr       , Rrc         , Rr^Vhc      , Rr^Vhc      , Rrc         , Rrc         , Rrc         , Rr          , Ch          , Ww          , Wwt         , Wwt         , Gg          , Ww          , Wwr^Bw\     , Rp          , Wwr         , Hhd         , Hhd         , Hhd         , Md          , Md          , Md          
Gs^Fds      , Gs^Fds      , Gs^Fds      , Gs^Fds      , Gg          , Gg          , Gg          , Gg          , Gs          , Gs          , Gg^Gvs      , Gg^Gvs      , Gg^Gvs      , Rp          , Rp          , Gg          , Gg          , Wwt         , Ww          , Ww          , Ch          , Ww          , Ch          , Rrc         , Rrc^Dr      , Rr^Vhc      , Rr          , Rr^Vhc      , Rr          , Rp^Vhcr     , Chr         , Ch          , Ch          , Ww          , Ww          , Ww          , Gg          , Gg          , Rp          , Gg          , Gg          , Hhd         , Gg          , Hhd         , Hhd         , Hhd         
Gs^Fds      , Gs^Fds      , Gs^Fds      , Gs^Fds      , Gg          , Gg          , Gs          , Gg^Gvs      , Gs^Gvs      , Gs^Gvs      , Gs          , Gg^Gvs      , Gg^Gvs      , Gg^Gvs      , Rp          , Gs^Vh       , Wwr^Bw\     , Wwt         , Ww          , Chr         , Wwt         , Ch          , Rr^Vhc      , Rrc         , Rr^Vhc      , Rrc         , 1 Khr       , Kh          , Kh          , Ch          , Rb^Dr       , Rb          , Rr          , Ch          , Ww          , Wwt         , Gg^Efm      , Gg          , Gg          , Rp          , Rp          , Gg          , Gg^Gvs      , Gg          , Gg          , Gg          
Gs^Fds      , Gs^Fds      , Gs^Fds      , Gg          , Gg          , Gg          , Gg          , Gs^Gvs      , Gs          , Gs          , Gs          , Gs^Gvs      , Rp          , Rp          , Gg          , Gg          , Wwr         , Wwt         , Ww          , Ww          , Wwt         , Wwt^Bw\     , Rrc         , Rrc         , Rrc         , Rr^Vhc      , Kh          , 2 Kud       , Kh          , Rrc         , Rrc         , Rr^Vhcr     , Rr          , Ch          , Ww          , Wwt         , Gg          , Gg          , Gg^Gvs      , Gg^Gvs      , Rp          , Gg^Gvs      , Gg^Gvs      , Gg^Gvs      , Gg^Gvs      , Gg          
Gs^Fds      , Gs^Fds      , Gs^Fds      , Gs          , Gs          , Gg          , Gs          , Gg          , Gs          , Gd^Esd      , Rp          , Rp          , Gg          , Gg          , Gg^Efm      , Wwr         , Wwt         , Wwt         , Ww          , Ww          , Wwt         , Wwt^Bw/     , Rr^Vhc      , Rr^Vhc      , Rr^Vhc      , Rrc         , Rr^Vhc      , Kh          , Rrc         , Rrc         , Gg^Fet      , Rrc         , Chr         , Chr         , Ww          , Wwt         , Wwt         , Gg^Gvs      , Gg^Gvs      , Gg^Gvs      , Rp          , Gg^Gvs      , Gg^Gvs      , Gg^Gvs      , Gg^Gvs      , Gg^Gvs      
Gs^Fds      , Gs^Fds      , Gg          , Gg          , Gg          , Gs^Es       , Gs          , Gs          , Gs          , Gs^Es       , Rp          , Gg^Wm       , Gg^Efm      , Gg^Efm      , Wwt         , Wwt         , Wwt         , Wwt         , Ww          , Ch          , Ch          , Ch          , Ch          , Rr          , Rrc         , Rrc         , Rrc         , Ch          , Rr          , Rrc         , Rrc         , Rrc         , Rrc         , Ch          , Ch          , Ww          , Wwt         , Gg^Gvs      , Gg^Gvs      , Gg^Gvs      , Rp          , Gs^Vl       , Gg          , Gg^Gvs      , Gg^Gvs      , Gg^Gvs      
Gs^Fds      , Gg          , Ce          , Ce          , Gs^Vdt      , Gs          , Gd          , Gd          , Gg          , Gg          , Ch          , Rrc         , Wwt^Bsb\    , Wwt         , Wwt         , Wwt         , Gg          , Ww          , Ww          , Ww          , Ww          , Ww          , Ww          , Ch          , Rr          , Rr^Vhc      , Rr^Vhc      , Ch          , Rr          , Rr^Vhc      , Rr^Vhc      , Ch          , Ch          , Rrc         , Wot^Bsb\    , Ww          , Wwr         , Gg^Gvs      , Rp          , Rp          , Rr^Vhc      , Gg          , Rr          , Rr^Wm       , Gg          , Gg^Gvs      
Gs^Fds      , Gg          , Ce          , Ce          , Ce          , Gd          , Gd^Es       , Gs          , Gs          , Gg          , Wwt         , Wwt         , Wwt         , Wwt^Bsb\    , Rrc         , Gg^Es       , Gg          , Wwr         , Wwr         , Wwt         , Wwt         , Ww          , Ww          , Ch          , Ch          , Rr          , Ch          , Ch          , Ch          , Rr          , Ch          , Ch          , Ww          , Ch          , Ww          , Wwt^Bsb\    , Rr^Bsb\     , Rr^Vhc      , Rp          , Rr          , Rp          , Rp          , Rr^Vhc      , Gg          , Gs^Vh       , Gg          
Gg          , Gg          , Ce          , 3 Ke        , Ce          , Re          , Gd          , Gs          , Gg          , Wwt         , Wwt         , Wwt         , Gg          , Ch          , Gg          , Rrc         , Rp          , Gg          , Gg          , Gd          , Gd          , Wwt         , Wwt         , Ww          , Ww          , Ch          , Ww          , Ww          , Ww          , Ch          , Ww          , Ww          , Wwt         , Ww          , Wwr         , Wwt         , Rrc         , Rrc         , Rrc         , Rr          , Rp          , Rp          , Rp          , Rp          , Rp          , Gg          
Gs          , Gs          , Gg^Vdt      , Ce          , Ce          , Gd          , Gs          , Gs          , Wwt         , Wwt         , Wwt         , Wwt         , Gg          , Gg          , Gg          , Gg          , Gs          , Rp          , Rp          , Gs^Vh       , Gg          , Gd          , Gll         , Wwt         , Wwt         , Ww          , Wwt         , Wwt         , Wwt         , Ww          , Wwt         , Wwt         , Gs^Vh       , Wwt^Bw/     , Rrc         , Rrc         , Rp          , Rr^Vhc      , Rp          , Rrc         , Rrc         , Rr^Vhc      , Rp          , Rr^Vhc      , Ch          , Gg          
Gs          , Gs          , Gs          , Ce          , Gs          , Gs          , Gs          , Gg          , Wwt         , Wwt         , Wwt         , Gg          , Gg          , Gg          , Gg          , Gs          , Gd^Gvs      , Gd^Gvs      , Gs^Gvs      , Rp          , Rp          , Gg^Efm      , Gg          , Gll         , Gll         , Wwt         , Gg          , Gg          , Gg          , Wwt         , Gg          , Gg          , Rrc         , Rrc         , Gg^Gvs      , Rp          , Rr^Vhc      , Rp          , Rr^Vhc      , Rp          , Rr^Vhc      , Rrc         , Rrc         , Ch          , Gs^Vl       , Gg          
Gd          , Gd          , Gs          , Gs          , Gs^Es       , Gs          , Gg          , Gg          , Wwt         , Wwt         , Wwt         , Gg          , Gg          , Gg          , Re          , Gs^Gvs      , Gs          , Gs^Gvs      , Gs^Gvs      , Gs^Gvs      , Gs^Gvs      , Rp          , Rp          , Gg          , Gs^Wm       , Gg          , Gg^Gvs      , Gd^Es       , Gg^Gvs      , Gg          , Rr          , Rrc         , Gg^Gvs      , Gg^Gvs      , Gg^Gvs      , Gg^Gvs      , Gg^Gvs      , Rp          , Rp          , Rp          , Ch          , Ch          , Gg^Gvs      , Rrc         , Rrc         , Gg          
Gd          , Gd          , Gs          , Gs          , Gg          , Gg          , Wwt         , Wwt         , Wwt         , Wwt         , Gg          , Gg          , Gg          , Gs          , Gs          , Gg^Gvs      , Gd          , Re          , Re          , Gd          , Gs^Gvs      , Gg^Gvs      , Gs^Vh       , Rp          , Rp          , Gg^Gvs      , Gg^Gvs      , Gg^Gvs      , Rr          , Rrc         , Gg^Gvs      , Gg          , Gg          , Gg^Gvs      , Gg^Gvs      , Gg^Gvs      , Gg^Gvs      , Gg^Gvs      , Gs^Vl       , Gg^Gvs      , Gg^Gvs      , Gg^Gvs      , Gg^Gvs      , Gg^Gvs      , Gg^Gvs      , Rrc         
Gs          , Gs          , Gs          , Gg          , Gg          , Wwt         , Wwt         , Wwt         , Wwt         , Gg          , Gg          , Gg          , Gg          , Gg          , Gg          , Gs          , Gd^Gvs      , Gd          , Gs          , Gd^Gvs      , Gs          , Gg          , Gg          , Gg^Gvs      , Gg^Gvs      , Rp          , Rrc^Es      , Rp          , Gg^Gvs      , Gg^Gvs      , Gg^Gvs      , Gg          , Gg          , Gg          , Gg          , Gg^Gvs      , Gg          , Gg          , Gg          , Gg          , Gg^Efm      , Gg^Gvs      , Gg^Gvs      , Gg^Gvs      , Gg^Gvs      , Gg^Gvs      
Wwt         , Gs          , Gg          , Gs          , Wwt         , Wwt         , Wwt         , Wwt         , Gg          , Gg          , Gg          , Gg          , Gs          , Gg          , Gg^Es       , Gg          , Gs          , Gs^Gvs      , Gs          , Gg          , Ce          , Gs          , Gs^Es       , Gs^Gvs      , Gd^Esd      , Gg^Gvs      , Rrc         , Gs^Gvs      , Gd^Gvs      , Gd          , Gg^Gvs      , Gg          , Gs^Fds      , Gs^Fds      , Gs^Fds      , Gg          , Gs          , Gg          , Gg^Gvs      , Gg          , Gg^Wm       , Gg          , Gg          , Gg^Gvs      , Gg^Gvs      , Gg^Gvs      
Wwt         , Wwt         , Wwt         , Wwt         , Wwt         , Wwt         , Wwt         , Gg          , Gg          , Gs          , Gs          , Gd          , Gs          , Gs          , Gg          , Gg          , Gs          , Gg          , Gs          , Gs^Vdt      , Ce          , Gs          , Gs          , Gd^Esd      , Gd^Esd      , Gs^Gvs      , Rr          , Gs^Gvs      , Gd          , Gd^Gvs      , Gg^Gvs      , Gg          , Gs^Fds      , Gs^Fds      , Gg          , Gs          , Gg^Gvs      , Gg^Gvs      , Gg^Gvs      , Gg^Gvs      , Gg^Gvs      , Gg^Efm      , Gg          , Gg          , Gg          , Gg          
Wwt         , Wwt         , Wwt         , Wwt         , Wwt         , Wwt         , Gg          , Gg          , Gs          , Gs          , Gg          , Gg          , Gs^Fds      , Gg          , Gs^Fds      , Gg          , Gs          , Gs          , Ce          , Ce          , 4 Ke        , Ce          , Ce          , Gd^Gvs      , Gs^Gvs      , Gs^Gvs      , Rr          , Gs^Gvs      , Gd          , Gd^Gvs      , Gg^Gvs      , Gg          , Gs^Fds      , Gg          , Gg^Gvs      , Gg^Gvs      , Gg^Gvs      , Gg^Gvs      , Gg^Gvs      , Gg^Gvs      , Gg          , Gg          , Gg          , Gg          , Gs^Fds      , Gg          
Gg          , Gg          , Gg          , Gg          , Gg          , Gg          , Gg          , Gg          , Gs          , Gs          , Gs^Fds      , Gs^Fds      , Gs^Fds      , Gs^Fds      , Gs^Fds      , Gs^Fds      , Gs^Fds      , Gs          , Gs          , Ce          , Ce          , Ce          , Gs          , Gd^Gvs      , Rp          , Rp          , Gs^Vh       , Gg          , Gg          , Gg^Gvs      , Gg          , Gg          , Gs^Fds      , Gg          , Gg          , Gg^Gvs      , Gg^Gvs      , Gg^Gvs      , Gg          , Gg          , Gg          , Gg^Efm      , Gs^Fds      , Gs^Fds      , Gs^Fds      , Gs^Fds      
Gg          , Gs          , Gs          , Gg          , Gg          , Gg          , Gs^Fds      , Gg          , Gs^Fds      , Gs^Fds      , Gs^Fds      , Gs^Fds      , Gs^Fds      , Gs^Fds      , Gs^Fds      , Gs^Fds      , Gs^Fds      , Gs^Fds      , Gs^Fds      , Gs          , Ce          , Gg^Vdt      , Rp          , Rp          , Gs          , Gs          , Gs          , Gg          , Gg          , Gg          , Gs^Fds      , Gs^Fds      , Gs^Fds      , Gs^Fds      , Gs^Fds      , Gg          , Gg          , Gg^Efm      , Gg          , Gg          , Gs^Fds      , Gs^Fds      , Gs^Fds      , Gs^Fds      , Gs^Fds      , Gs^Fds      
Gg          , Gg          , Gg          , Gg          , Gg          , Gs^Fds      , Gs^Fds      , Gs^Fds      , Gs^Fds      , Gs^Fds      , Gs^Fds      , Gs^Fds      , Gs^Fds      , Gs^Fds      , Gg          , Gs^Fds      , Gg          , Gs^Fds      , Gg          , Gg          , Rr          , Rp          , Gg          , Gs          , Gg          , Gs          , Gs          , Gg          , Gg          , Gs^Fds      , Gg          , Gs^Fds      , Gg          , Gs^Fds      , Gg          , Gg          , Gg          , Gg          , Gg          , Gs^Fds      , Gs^Fds      , Gs^Fds      , Gs^Fds      , Gs^Fds      , Gs^Fds      , Gs^Fds      
